R 1000 500
NO ./maps/map.cub
SO ./maps/map.cub
WE ./maps/map.cub
EA ./maps/map.cub
S ./maps/map.cub

C 225,0,1
F 220,1,1

111111111111111111
1110002000N000000111111111111111111111111111111
111111111111111111
