R  800 600

NO ../xpm/bluestone.xpm
SO ../xpm/colorstone.xpm
WE ../xpm/eagle.xpm
EA ../xpm/redbrick.xpm
S ../xpm/barrel.xpm

F 128 , 128, 128
C 0, 165, 255

   11111111111111111111111
11110000000000000000000001
11110010000000000000000001
10000000000000111111111111
10000000000000000000001
10000000000000000000001
10000000000000000000001
10000020000000000000001
11111100000000100001111
110000000000000000000011
 10N0111111111111111111111
 10001
111111
