R  800 600

NO ../xpm/matrix.xpm
SO ../xpm/matrix.xpm
WE ../xpm/matrix.xpm
EA ../xpm/matrix.xpm
S ../xpm/meshok.xpm

F 128 , 128, 128
C 0, 165, 255

1111111111111
10001XYP10001
10Z0000000H01
103000N002001
10D000000M001
100000A000001
1020000000001
1000020002001
1000000000001
1000000000001
1000000000001
1000000000001
1000000000001
1000000000001
1000000000001
1000000000001
1000000000001
1000000000001
1000000000001
1000000000001
1000000000001
1000000000001
1000000000001
1000000000001
1000000000001
1111111111111
