R  800 600

NO ../xpm/matrix.xpm
SO ../xpm/matrix.xpm
WE ../xpm/matrix.xpm
EA ../xpm/matrix.xpm
S ../xpm/bluestone.xpm

F 128 , 128, 128
C 0, 165, 255

111111111111111111111111111111111
10001XYP1000100000000000000000001
100000000000100000000000000000001
100000N0000010000Y00000M000000001
100000000000100000000000000000001
100000200000100000000000000000001
111111111111111111111111111111111
