R 1920 1080
NO ./maps/map.cub
SO ./maps/map.cub
WE ./maps/map.cub
EA ./maps/map.cub

S ./maps/map.cub
F 220,100,0
C 225,30,0

111111111
111111111
11000N111
111111111
111111111