R  800 600

NO ./xpm/matrix.xpm
SO ./xpm/matrix.xpm
WE ./xpm/matrix.xpm
EA ./xpm/matrix.xpm
S ./xpm/barrel.xpm

F 128 , 128, 128
C 0, 165, 255

   11111111111111111111111
11110000000000000000000021
11110010000022222000000001
10000000000000111111111111
10000000000000000000001
10000000020000000000001
10000000000000000000001
10000020000000002000001
11111100000000100001111
11000000000002200000011
 10N0111111111111111111111
 10001
111111
