R 1920 1080
NO ./maps/map.cub
SO ./maps/map.cub
WE ./maps/map.cub
EA ./maps/map.cub

S ./maps/map.cub
F 220,100,0
C 225,30,0

        1111111111111111111111111
        1000000000110000000000001
        1011000001110000002000001
        1001000000000000000000001
111111111011000001110000000000001
100000000011000001110111111111111
11110111111111011100000010001
11111111111111111111111111111111
 
11111111111111111111111111111
11110111111111011101010010001
11000000110101011100000010001
100020000000000011000000100011101
100000000000000011010100100000001
110000011101010111110111100011111
11110111 1110101N101111010001
11111111 11111111111111111111
