R 1920 1200
NO ./maps/map.cub
SO ./maps/map.cub
WE ./maps/map.cub
     EA         ./maps/map.cub       
C 225,0,           1
S ./maps/map.cub
F 220,1,1
   

111111111111111111
111011111111111111111111111111111111
11111111N111111100000000000001
111111111111111111111111111111
111
111111111111111                       11111111
111111111111111                       10000001
1111111111111111111111111111111111111110111101
1111111111111111111111111111111111111110111111
11111  1111111111111111111111111111111111111111111111111111111111111111
101 11111
111 1
