R  1000 600

NO ../xpm/dver.xpm
SO ../xpm/dver.xpm
WE ../xpm/dver.xpm
EA ../xpm/dver.xpm
S ../xpm/meshok.xpm

F 255, 255, 255
C 255, 255, 255
    1111111111111111111111111
    1555555555555555555555551
    1500000000000000000000X51
    1500000000000000000000Y51
    1560000000000000000000P51
    1534555555555555555555551
    1505111111111111111111111
    11011
     101
     101
     101
     101
     101
     101
     101
     101
     101
     101
     101
     101
     101
     101
     101
     101
     101
     101
     101
     101
     101
     101
     101
     101
     101
     101
     101
     101
     101
     101
     101
     101
     101
     101
     101
     101
     1N1
     101
     101
     101
     101
     101
     101
     101
     101
     101
     101
     101
     101
     101
     101
     101
     101
     101
     101
     101
     101
     101
     101
     101
     101
     101
     101
     101
     101
     101
     101
     101
     101
     101
     101
     101
     101
     101
     101
     101
     101
     101
     101
     101
     101
     101
     101
     101
     101
     101
     101
     101
     101
     101
     101
     101
     101
     101
     101
     101
     101
     101
     101
     101
     101
     101
     101
     101
     101
     101
     101
     101
     101
     101
     101
     101
     101
     101
     101
     101
     101
     101
     101
     101
     101
     101
     101
     101
     101
     101
     101
     101
     101
     101
     101
     101
     101
     101
     101
     101
     101
     101
     101
     101
     101
     101
     101
     101
     101
     101
     101
     101
     101
     101
     101
     101
     101
     101
     101
     101
     101
     101
     101
     101
     101
     101
     101
     101
     101
     101
     101
     101
     101
     101
     101
     101
     101
     101
     101
     101
     101
     101
     101
     101
     101
     101
     101
     101
     101
     101
     101
     101
     101
     101
     101
     101
     101
     101
     101
     101
     101
     101
     101
     101
     101
     101
     101
     101
     101
     101
     101
     101
     101
     101
     101
     101
     101
     101
     101
     101
     101
     101
     101
     101
     101
     101
     101
     101
     101
     101
     101
     101
     101
     101
     101
     101
     101
     101
     101
     101
     101
     101
     101
     101
     101
     101
     101
     101
     101
     101
     101
     101
     101
     101
     101
     101
     101
     101
     101
     101
     101
     101
     101
     101
     101
     101
     101
     101
     101
     101
     101
     101
     101
     101
     101
     101
     101
     101
     101
     101
     101
     101
     101
     101
     101
     101
     101
     101
     101
     101
     151
     111