R 1920 1080
NO ./maps/map.cub
SO ./maps/map.cub
WE ./maps/map.cub
EA ./maps/map.cub

S ./maps/map.cub
F 220,100,0
C 225,30,0

111111111111111111
111011111111111111111111111111111111
11111111N111111100000000000001
111111111111111111111111111111
111
111111111111111
111
111111111111111111111111111111111111111
1111111111111
111111111111111111111111111111111111111111111111111111111111111111111
10111111
1111
