R 1900 1200
NO ./maps/map.cub
SO ./maps/map.cub
WE ./maps/map.cub
     EA         ./maps/map.cub       
C 225,0,           1
S ./maps/map.cub
F 220,1,1
   

111111111111111111
1110000000000000011111111111111111111111111111
1111111101111111000000000000000000000000000001
1111111100000000000000000011110000000000000001
1110000000000000000W00000011111111111111111111
1111111111111110000000000000000000000011111111
1100000000000110000000000000000000000000000001
1101111111110111111111111111111111111110111101
1101111111100000000000000000000000000000111111
10011  111111111111111111111111111111111111111
101111111111111111                           1
1111111111111111111111111111111111111111111111
