R 2000 1000
NO ../maps/map.cub
SO ../maps/map.cub
WE ../maps/map.cub
EA ../maps/map.cub
S ../maps/map.cub

C 225,0,1
F 220,1,1

11111111111111111111111
10000000000000000000001
10010000002000000000001
10000000000000111111111
10000000000000000000001
1000000000N000000000001
10000000000000000200001
10000000000000000000001
10001000000000100000001
10000000000000000000001
11111111111111111111111
