R  1000 600

NO ./xpm/matrix.xpm
SO ./xpm/matrix.xpm
WE ./xpm/matrix.xpm
EA ./xpm/matrix.xpm
S ./xpm/mmmatrixxx.xpm

F 128, 128, 128
C 0, 165, 255

11111111111111111111111111111111111111111111111111111111111111111111111111111111111111111111111111111111111111111111111111111111111111111111111111111111111111111111111111111111111111111111111111111111111111111111111111111111111111111111111111111111111111111111111111111111111111111111111111111111111
100000Y00000100000000100000000000000000000100000000000001C000000000000C10000000000000000000010000000000000000100000000000000000000000000000000000000000000000000000000000000000000000000000000000000700000000000001000000000000000V00000000000000000000000010000000000000V00000000000000000001A0000000000H1
10000000000010HC00CA0100C0H0A0C0H0A0C0H0A010000000000000100A0H0C0A0H0C0100H0000V00000V0000H010000000000000000100A00H00C00C00H00000000000000000000000000000000000000000000000000000000000A000000000007000000000000010000000000000001000000000000000000000000100000000000001000000000000000000010000CCC000001
1000000000001000CC000100000000000000000000V000000C000000100A0H0C0A0H0C0100000000000000000000V0000000C000000003000000000000000000000C000C0000C00000000C000000000000C000000000C0000000000000000000000070000000000000V00000000000000010000000000000000000000001000000000000010000000000000000000V0000CCC000001
100000N0000010HC00CA0100000000100000C000001000000000000010A0H0C0A0H0C77100C000000000000000C010000000000000000100H00A00C00C00A00000000000000000000000000000000000000000000000000000000000H000000000007000000000000010000000000000001000000000000000000000000100000000000001000000000000000000010000CCC000001
100000000000100000000100000000100000000000100000000000001CA0H0C0A0H0C7V300000000000000000000100000000000000001000000000000000000000000000000000000000000000000000000000000000000000000000000000000007000000000000010000000000000001000000000000000000000000V0000000000000100000000000000000001H0000000000A1
1111100011111111311111111V1111111111V111111111111V11111111111111111111111111111111V111111111111V11111111111V11111111111111111111111111111111111111111111111111111111111111111111111111111111111111111111311111111111111111111111111111111111111111111111111111111111111111111111111111111111111111111111111
10000000000010000000010000000010000000000010000000000000100000000000000100000000000000000000100000000000000001000000000000000000000000000000000000000000000000000000000000000000000000000000000000001000000001000000001000000001000000001000000001000000000700000000000001000000000000000000010000000000001
10000000000010000000010000000010000000000010000000000000100000000000000100000000000000000000100000000000000001000000000000000000000000000000000000000000000000000000000000000000000000000V00000000001000000007000000001000000001000000001000000001000000000100000000000001000000000000000000010000000000001
100000000000100000000100000000V000000000001000000C00000010000000000000010000000000000000000010000000A00000000100000000000000000000000000000000000000000V000000000000000000000000000000000000000000001000000001000000001000000001000000001000000001000000000100000000000001000000000000000000000000000000001
100000000000100000000100000000V00000V000001000000H00000000000000000000010000000000000000000010000000C00000000V0000000000000000000000000V00000000000000000000000000000V00000000000000000000000000000070000000010000000010000000010000000070000000010000000001000000000000030000000000000000000000000Z0000001
100000000000100000000100000000V000000000001000000A00000010000000C00000010000000000000000000010000000H00000000100000000000000000000000000000000000000000V000000000000000000000000000000000000000000001000000001000000001000000001000000001000000001000000000100000000000001000000000000000000000000000000001
10000000000010000000010000000010000000000010000000000000100000000000000100000000000000000000100000000000000001000000000000000000000000000000000000000000000000000000000000000000000000000V00000000001000000001000000007000000001000000001000000007000000000100000000000001000000000000000000010000000000001
10000000000010000000010000000010000000000010000000000000100000000000000100000000000000000000100000000000000001000000000000000000000000000000000000000000000000000000000000000000000000000000000000001000000001000000001000000007000000001000000001000000000100000000000001000000000000000000010000000000001
1000000000001000000000V11111111111111111111111111111111110000000000000011181111111111111181111111111V111111111111111111111111111111111111111111111111111111111111111111111111111111111111111111111111111111111111111111111111111111111111111111111111111111111111111111111111111111111111111111111111111111
1000000000001000000001000000001000000000001000000C000000100000000000000100000000000000000000100000000000000001
1000000000001000000001000V000010000000000010000000000000100000000000000100000000000000000000100000000000000001
10000000000010000000010000000010000000000010000000000000100000000000000100000000000000000000100000000000000001
1000000000001000000001000V000011000000000010000000000000100000000000000100000000000000000000100000000000000001
100000000000100000000110000000070000000000V0000000000000V0000C00000C000100000000000000000000100000000000000001
1000000000001000000000100000V001000000000010000000000000100000000000000100000000000000000000100000000000000001
1000000000001000000000100000000100000000001000V000000000100000000000000100000000000000000000100000000000000001
1000000000001000000000100V000001000000000010000000000000100000000000000100000000000000000000100000000000000001
1000000000001000000000111111111111111111111000000000000011V1111111111V11111111111181111111111111111111111VVV11
10000000000010000000001000000001000000000010000000000000100000000000000100000000000000000000100000000000000001
100000000000100000000010000C00010000A0000010000000000000100000000000000100000000000000000000100000000000000001
10000000000010000000001000000001000000000010000000000000100000000000000100000000000000000000100000000000000001
10000000000010000000001000000001000000000010000000000000100000000000000100000000000000000000100000000000000001
1000000000001000000000300000000100000000001000000000000010000000C00000010000000000000000000010000000C000000001
1000000000001000000000100000000100000000001000000000V000100000000000000100000000000000000000100000000000000001
100000000000100000000010000C000V0000A0000010000000000000100000000000000100000000000000000000100000000000000001
10000000000010000000001000000001000000000010000000000000100000000000000100000000000000000000100000000000000001
1000000000001000000000111111111111111111111000000000000011111111V11111111181111111111111181111VVV1111111111111
1000000000001000000000V0000000010000000000100000000000001A000000V00000H1CV0V000000000000V0VC100000000000000001
100000000000100000000010000000010C00HA00C0100000000000001000000V0V000001VV0000000000000000VV100000000000000001
1000000000001000000000100000000100000000001000V000000000100000000000000100000000000000000000100000000000000001
100000000000100000000010000000010000000000V0000000000000100000000000000100000000000000000000100000000000000001
10000000000000000000001000000010000000000010000000000000100000000000000100000000000000000000100000000000000001
1000000000000000000000100000001000000000001000000000000010000000C000000100000000000000000000100000000000000001
100000000000000000000010000000100000000000100000000000001000000000000001VV0000000000000000VV100000000000000001
100000000000000000000010000000V00000000000100000000000001000000000000001CV0000000000000000VC100000000000000001
1111111111000111111111111111111111111111111000000000000011V111111111V11111V11111118111111V1111111111111111VVV1
100000000000000000000010000000000000000000100000000000000000000000000001000000V0V000V0V00000100000000000000001
100000000000000000000010000000000V0000000010000000000000100000000000000100000000000000000000100000000000000001
100000000000000000000010000V0000000000000010000000000000100A00000000A00100000000000000000000100000000000000001
1000000000000000000000V0000000000000000000V0000000000000100000000000000100000000000000000000100000000000000001
100000000000000000000010000000000V0000000010000000000000100000000000000100000000000000000000100000000000000001
100000000000000000000010000000000000000000100000V0000000100000000000000100000000000000000000100000000000000001
100000000000000000000011111111111111111111100000000000001000000H00000001111111111181111111111VVV11111111111111
1000000000000000000000000V0000000000000000100000000000001000000000000001000000000V0V000000001000000000020V0V01
1000000000000000000000000000000000000000V010000000000000100000000000000100000000000000000000100000000020V00001
1000000000000000000000000000000000V00000001000000000000010000000000000010000000000000000000010000000020V0V0V01
10000000000000000000000000000V00000000V000V00000000000001000000000000001000000000000000000001000000000V0000001
1000000000000000000000000000000000V000000010000000000000100000000000000100000000000000000000100000020V0V00V001
1000000000000000000000000000000000000000V01000V00000000010H0000000000H010000000000000000000010000020V000000001
1000000000000000000000000V0000000000000000100000000000001000000000000001000000000000000000001000020V0V00V00001
1000000000000000000000111111111111111111111000000000V00011111111V11111111111111111811111111111111111111111VVV1
1000000000000000000000100000000000000000001000000000000010000000000000010000000000000000000010000000000000VVV1
10000000000000000000001000000000000000000010000000000000100000000000000100000000000000000000100000000000000001
10000000000000000000001000C00000000000C00010000000000000100000000000000100000000000000000000100000000000000001
10000000000000000000001000000000000000000010000000000000100000000000000100000000000000000000100000000000000001
10000000000000000000001000000C0000000000001000000000000010000000V0000001000C000000000000C000100000000000000001
1000000000000000000000100000000000000000001000000000V000100000000000000100000000000000000000100000000000000001
10000000000000000000001000000000C00000000010000000000000100000000000000100000000000000000000100000000000000001
1000000000000000000000100000000000000000001000V000000000100000000000000100000000000000000000100000000000000001
10000000000000000000001000000000000C00000010000000000000100000000000000100000000000000000000100000000000000001
10000000000000000000001000000000000000000010000000000000100V00000000V00100000000000000000000100000000000000001
10000000000000000000001000000000000000C0001000V000000000100000000000000100000000000000000000100000000000000001
1000000000000000000000100V000000000000000010000000000000100000000000000100000000000000000000100000000000000001
10000000000000000000001000000000000000000010000000000V0010000000000000010000000000000000000011111111111G111111
100000000000000000000010000000V0000000000010000000000000100000000000000100000000000000000000100000000000000001
10000000000000000000001000000000000000000010000000000000100000000000000100000000000000000000100000000000000001
100000000000000000000010000000000000000000100V0000000000100000000000000100000000000000000000100000000000000001
10000000000000000000001000000000000000000010000000000000100000000000000100000000000000000000100000000000000001
10000000000000000000001000000000000V0000001000000V000000C00000000000000100000000000000000000100000000000000001
100000000000000000000010000000000000000000100000000000V0000000000000000100000000000000000000100000000000000001
10000000000000000000001000000000000000000010000000000000C00000000000000100000000000000000000100000000000000001
10000000000000000000001000000000000V000000100V000000V000000000000000000100000000000000000000100000000000000001
1000000000000000000000V000000000000000000010000000000000C00000000000000100000000000000000000100000000000000001
11111111110001111111111111111111111111111111111113111111100000000000000111111111VVV111111111100000000000000001
10000000000000000000001000000000000000000010000000000000100000000000000100000000000000000000100000000000000001
1000000000000000000000100000A0000000H00000100C000C000C00100000000000000100000000000000000000100000000000000001
10H00C00000D00000C00H01000000000000000000010000000000000100000000000000100000000000000000000100000000000000001
100000000A000A000000001000000000M00000000010000000000000100000000000000V000000000V0000000000100011111111111111
131111111111111111111110000000000000000000100C000C000C00100000000000000100000000000000000000100099999999999991
1000000A00000H00000000700000H0000000A000001000A0H0A0H00010000000V0000001000000000000000000001000000000000000Q1
1000H00000A00000A000007000000000000000000070000000000000100000000000000100000000000000000000100099999999999991
11111111111111111111111111111111111111111111111111111111111111111111111111111111111111111111111111111111111111