R  800 600

NO ../xpm/matrix.xpm
SO ../xpm/matrix.xpm
WE ../xpm/matrix.xpm
EA ../xpm/matrix.xpm
S ../xpm/meshok.xpm

F 128 , 128, 128
C 0, 165, 255

11111111111111111111111111111111111111111111111111111111111111111111111111111111111111111111111111111111111111111111111111111111111111111111111111111111111111111111111111111111111111111111111111111111111111111111111111111111111111111111111111111111111111111111111111111111111111111111111111111111111
100000Y0000010000000010000000000000000000010000000000000100000000000000100000000000000000000100000000000000001000000000000000000000000000000000000000000000000000000000000000000000000000000000000001000000000000010000000000000001000000000000000000000000100000000000001000000000000000000010000000000001
10000000M00010000000010000000000000000000010000000000000100000000000000100000000000000000000100000000000000001000000000000000000000000000000000000000000000000000000000000000000000000000000000000001000000000000010000000000000001000000000000000000000000100000000000001000000000000000000010000000000001
100000N00000100000000100000000000000000000Y0000000000000100000000000000100000000000000000000100000000000000001000000000000000000000000000000000000000000000000000000000000000000000000000000000000001000000000000010000000000000001000000000000000000000000100000000000001000000000000000000010000000000001
10000000000010000000010000000010000000000010000000000000100000000000000100000000000000000000100000000000000001000000000000000000000000000000000000000000000000000000000000000000000000000000000000001000000000000010000000000000001000000000000000000000000100000000000001000000000000000000010000000000001
10000000000010000000010000000010000000000010000000000000100000000000000100000000000000000000100000000000000001000000000000000000000000000000000000000000000000000000000000000000000000000000000000001000000000000010000000000000001000000000000000000000000100000000000001000000000000000000010000000000001
1111110111111111Y111111110111111111111111111111110111111111111111111111111111111111111111111111111111111111111111111111111111111111111111111111111111111111111111111111111111111111111111111111111111111111111111111111111111111111111111111111111111111111111111111111111111111111111111111111111111111111
10000000000010000000010000000010000000000010000000000000100000000000000100000000000000000000100000000000000001000000000000000000000000000000000000000000000000000000000000000000000000000000000000001000000001000000001000000001000000001000000001000000000Y00000000000001000000000000000000010000000000001
1000000000001000000001000000001000000000001000000000000010000000000000010000000000000000000010000000000000000100000000000000000000000000000000000000000000000000000000000000000000000000000000000000100000000Y000000001000000001000000001000000001000000000100000000000001000000000000000000010000000000001
10000000000010000000010000000000000000000010000000000000100000000000000100000000000000000000100000000000000001000000000000000000000000000000000000000000000000000000000000000000000000000000000000001000000001000000001000000001000000001000000001000000000100000000000001000000000000000000000000000000001
1000000000001000000001000000000000000000001000000000000000000000000000010000000000000000000010000000000000000100000000000000000000000000000000000000000000000000000000000000000000000000000000000000Y00000000100000000100000000100000000Y00000000100000000010000000000000Y0000000000000000000000000Z0000001
10000000000010000000010000000000000000000010000000000000100000000000000100000000000000000000100000000000000001000000000000000000000000000000000000000000000000000000000000000000000000000000000000001000000001000000001000000001000000001000000001000000000100000000000001000000000000000000000000000000001
1000000000001000000001000000001000000000001000000000000010000000000000010000000000000000000010000000000000000100000000000000000000000000000000000000000000000000000000000000000000000000000000000000100000000100000000Y00000000100000000100000000Y000000000100000000000001000000000000000000010000000000001
1000000000001000000001000000001000000000001000000000000010000000000000010000000000000000000010000000000000000100000000000000000000000000000000000000000000000000000000000000000000000000000000000000100000000100000000100000000Y000000001000000001000000000100000000000001000000000000000000010000000000001
100000000000100000000011111111111111111111111111111111111000000000000001111111111111111111111111111111111111111111111111111111111111111111111111111111111111111111111111111111111111111111111111111111111111111111111111111111111111111111111111111111111111111111111111111111111111111111111111111111111111
10000000000010000000010000000010000000000010000000000000100000000000000100000000000000000000100000000000000001000000000000000000000000000000000000000000000000000000000000000000000000000000000000001000000000000010000000000000001000000000000000000000000100000000000001000000000000000000010000000000001
10000000000010000000010000000010000000000010000000000000100000000000000100000000000000000000100000000000000001000000000000000000000000000000000000000000000000000000000000000000000000000000000000001000000000000010000000000000001000000000000000000000000100000000000001000000000000000000010000000000001
10000000000010000000010000000010000000000010000000000000100000000000000100000000000000000000100000000000000001000000000000000000000000000000000000000000000000000000000000000000000000000000000000001000000000000010000000000000001000000000000000000000000100000000000001000000000000000000010000000000001
10000000000010000000010000000010000000000010000000000000100000000000000100000000000000000000100000000000000001000000000000000000000000000000000000000000000000000000000000000000000000000000000000001000000000000010000000000000001000000000000000000000000100000000000001000000000000000000010000000000001
10000000000010000000001000000001000000000000000000000000000000000000000100000000000000000000100000000000000001000000000000000000000000000000000000000000000000000000000000000000000000000000000000001000000000000010000000000000001000000000000000000000000100000000000001000000000000000000010000000000001
10000000000010000000001000000001000000000010000000000000100000000000000100000000000000000000100000000000000001000000000000000000000000000000000000000000000000000000000000000000000000000000000000001000000000000010000000000000001000000000000000000000000100000000000001000000000000000000010000000000001
10000000000010000000001000000001000000000010000000000000100000000000000100000000000000000000100000000000000001000000000000000000000000000000000000000000000000000000000000000000000000000000000000001000000000000010000000000000001000000000000000000000000100000000000001000000000000000000010000000000001
10000000000010000000001000000001000000000010000000000000100000000000000100000000000000000000100000000000000001000000000000000000000000000000000000000000000000000000000000000000000000000000000000001000000000000010000000000000001000000000000000000000000100000000000001000000000000000000010000000000001
10000000000010000000001111111111111111111110000000000000111111111111111111111111111111111111111111111111111111111111111111111111111111111111111111111111111111111111111111111111111111111111111111111111111111111111111111111111111111111111111111111111111111111111111111111111111111111111111111111111111
10000000000010000000001000000001000000000010000000000000100000000000000100000000000000000000100000000000000001000000000000000000000000000000000000000000000000000000000000000000000000000000000000001000000000000010000000000000001000000000000000000000000100000000000001000000000000000000010000000000001
10000000000010000000001000000001000000000010000000000000100000000000000100000000000000000000100000000000000001000000000000000000000000000000000000000000000000000000000000000000000000000000000000001000000000000010000000000000001000000000000000000000000100000000000001000000000000000000010000000000001
10000000000010000000001000000001000000000010000000000000100000000000000100000000000000000000100000000000000001000000000000000000000000000000000000000000000000000000000000000000000000000000000000001000000000000010000000000000001000000000000000000000000100000000000001000000000000000000010000000000001
10000000000010000000001000000001000000000010000000000000100000000000000100000000000000000000100000000000000001000000000000000000000000000000000000000000000000000000000000000000000000000000000000001000000000000010000000000000001000000000000000000000000100000000000001000000000000000000010000000000001
10000000000010000000001000000001000000000010000000000000100000000000000100000000000000000000100000000000000001000000000000000000000000000000000000000000000000000000000000000000000000000000000000001000000000000010000000000000001000000000000000000000000100000000000001000000000000000000010000000000001
10000000000010000000001000000001000000000010000000000000100000000000000100000000000000000000100000000000000001000000000000000000000000000000000000000000000000000000000000000000000000000000000000001000000000000010000000000000001000000000000000000000000100000000000001000000000000000000010000000000001
10000000000010000000001000000000000000000010000000000000100000000000000100000000000000000000100000000000000001000000000000000000000000000000000000000000000000000000000000000000000000000000000000001000000000000010000000000000001000000000000000000000000100000000000001000000000000000000010000000000001
10000000000010000000001000000001000000000010000000000000100000000000000100000000000000000000100000000000000001000000000000000000000000000000000000000000000000000000000000000000000000000000000000001000000000000010000000000000001000000000000000000000000100000000000001000000000000000000010000000000001
10000000000010000000001111111111111111111110000000000000111111111111111111111111111111111111111111111111111111111111111111111111111111111111111111111111111111111111111111111111111111111111111111111111111111111111111111111111111111111111111111111111111111111111111111111111111111111111111111111111111
10000000000010000000000000000001000000000010000000000000100000000000000100000000000000000000100000000000000001000000000000000000000000000000000000000000000000000000000000000000000000000000000000001000000000000010000000000000001000000000000000000000000100000000000001000000000000000000010000000000001
10000000000010000000001000000001000000000010000000000000100000000000000100000000000000000000100000000000000001000000000000000000000000000000000000000000000000000000000000000000000000000000000000001000000000000010000000000000001000000000000000000000000100000000000001000000000000000000010000000000001
10000000000010000000001000000001000000000010000000000000100000000000000100000000000000000000100000000000000001000000000000000000000000000000000000000000000000000000000000000000000000000000000000001000000000000010000000000000001000000000000000000000000100000000000001000000000000000000010000000000001
10000000000010000000001000000001000000000010000000000000100000000000000100000000000000000000100000000000000001000000000000000000000000000000000000000000000000000000000000000000000000000000000000001000000000000010000000000000001000000000000000000000000100000000000001000000000000000000010000000000001
10000000000000000000011000000010000000000010000000000000100000000000000100000000000000000000100000000000000001000000000000000000000000000000000000000000000000000000000000000000000000000000000000001000000000000010000000000000001000000000000000000000000100000000000001000000000000000000010000000000001
10000000000000000000001000000010000000000010000000000000100000000000000100000000000000000000100000000000000001000000000000000000000000000000000000000000000000000000000000000000000000000000000000001000000000000010000000000000001000000000000000000000000100000000000001000000000000000000010000000000001
10000000000000000000001000000010000000000010000000000000100000000000000100000000000000000000100000000000000001000000000000000000000000000000000000000000000000000000000000000000000000000000000000001000000000000010000000000000001000000000000000000000000100000000000001000000000000000000010000000000001
10000000000000000000001000000000000000000010000000000000100000000000000100000000000000000000100000000000000001000000000000000000000000000000000000000000000000000000000000000000000000000000000000001000000000000010000000000000001000000000000000000000000100000000000001000000000000000000010000000000001
11111111110001111111111111111111111111111110000000000000111111111111111111111111111111111111111111111111111111111111111111111111111111111111111111111111111111111111111111111111111111111111111111111111111111111111111111111111111111111111111111111111111111111111111111111111111111111111111111111111111
10000000000000000000001000000000000000000010000000000000000000000000000100000000000000000000100000000000000001000000000000000000000000000000000000000000000000000000000000000000000000000000000000001000000000000010000000000000001000000000000000000000000100000000000001000000000000000000010000000000001
10000000000000000000001000000000000000000010000000000000100000000000000100000000000000000000100000000000000001000000000000000000000000000000000000000000000000000000000000000000000000000000000000001000000000000010000000000000001000000000000000000000000100000000000001000000000000000000010000000000001
10000000000000000000001000000000000000000010000000000000100000000000000100000000000000000000100000000000000001000000000000000000000000000000000000000000000000000000000000000000000000000000000000001000000000000010000000000000001000000000000000000000000100000000000001000000000000000000010000000000001
10000000000000000000000000000000000000000000000000000000100000000000000100000000000000000000100000000000000001000000000000000000000000000000000000000000000000000000000000000000000000000000000000001000000000000010000000000000001000000000000000000000000100000000000001000000000000000000010000000000001
10000000000000000000001000000000000000000010000000000000100000000000000100000000000000000000100000000000000001000000000000000000000000000000000000000000000000000000000000000000000000000000000000001000000000000010000000000000001000000000000000000000000100000000000001000000000000000000010000000000001
10000000000000000000001000000000000000000010000000000000100000000000000100000000000000000000100000000000000001000000000000000000000000000000000000000000000000000000000000000000000000000000000000001000000000000010000000000000001000000000000000000000000100000000000001000000000000000000010000000000001
100000000000000000000011111111111111111111100000000000001000000000000001111111111111111111111111111111111111111111111111111111111111111111111111111111111111111111111111111111111111111111111111111111111111111111111111111111111111111111111111111111111111111111111111111111111111111111111111111111111111
10000000000000000000001000000000000000000010000000000000100000000000000100000000000000000000100000000000000001000000000000000000000000000000000000000000000000000000000000000000000000000000000000001000000000000010000000000000001000000000000000000000000100000000000001000000000000000000010000000000001
10000000000000000000001000000000000000000010000000000000100000000000000100000000000000000000100000000000000001000000000000000000000000000000000000000000000000000000000000000000000000000000000000001000000000000010000000000000001000000000000000000000000100000000000001000000000000000000010000000000001
10000000000000000000001000000000000000000010000000000000100000000000000100000000000000000000100000000000000001000000000000000000000000000000000000000000000000000000000000000000000000000000000000001000000000000010000000000000001000000000000000000000000100000000000001000000000000000000010000000000001
10000000000000000000001000000000000000000010000000000000100000000000000100000000000000000000100000000000000001000000000000000000000000000000000000000000000000000000000000000000000000000000000000001000000000000010000000000000001000000000000000000000000100000000000001000000000000000000010000000000001
10000000000000000000001000000000000000000010000000000000100000000000000100000000000000000000100000000000000001000000000000000000000000000000000000000000000000000000000000000000000000000000000000001000000000000010000000000000001000000000000000000000000100000000000001000000000000000000010000000000001
10000000000000000000001000000000000000000010000000000000100000000000000100000000000000000000100000000000000001000000000000000000000000000000000000000000000000000000000000000000000000000000000000001000000000000010000000000000001000000000000000000000000100000000000001000000000000000000010000000000001
10000000000000000000001000000000000000000010000000000000100000000000000100000000000000000000100000000000000001000000000000000000000000000000000000000000000000000000000000000000000000000000000000001000000000000010000000000000001000000000000000000000000100000000000001000000000000000000010000000000001
100000000000000000000011111111111111111111100000000000001111111101111111111111111111111111111111111111111111111111111111111111111111111111111111111111111111111111111111111111111111111111111111111111111111111111111111111111111111111111111111111111111111111111111111111111111111111111111111111111111111
10000000000000000000001000000000000000000010000000000000100000000000000100000000000000000000100000000000000001000000000000000000000000000000000000000000000000000000000000000000000000000000000000001000000000000010000000000000001000000000000000000000000100000000000001000000000000000000010000000000001
10000000000000000000001000000000000000000010000000000000100000000000000100000000000000000000100000000000000001000000000000000000000000000000000000000000000000000000000000000000000000000000000000001000000000000010000000000000001000000000000000000000000100000000000001000000000000000000010000000000001
10000000000000000000001000000000000000000010000000000000100000000000000100000000000000000000100000000000000001000000000000000000000000000000000000000000000000000000000000000000000000000000000000001000000000000010000000000000001000000000000000000000000100000000000001000000000000000000010000000000001
10000000000000000000001000000000000000000010000000000000100000000000000100000000000000000000100000000000000001000000000000000000000000000000000000000000000000000000000000000000000000000000000000001000000000000010000000000000001000000000000000000000000100000000000001000000000000000000010000000000001
10000000000000000000001000000000000000000010000000000000100000000000000100000000000000000000100000000000000001000000000000000000000000000000000000000000000000000000000000000000000000000000000000001000000000000010000000000000001000000000000000000000000100000000000001000000000000000000010000000000001
10000000000000000000001000000000000000000010000000000000100000000000000100000000000000000000100000000000000001000000000000000000000000000000000000000000000000000000000000000000000000000000000000001000000000000010000000000000001000000000000000000000000100000000000001000000000000000000010000000000001
10000000000000000000001000000000000000000010000000000000100000000000000100000000000000000000100000000000000001000000000000000000000000000000000000000000000000000000000000000000000000000000000000001000000000000010000000000000001000000000000000000000000100000000000001000000000000000000010000000000001
10000000000000000000001000000000000000000010000000000000100000000000000100000000000000000000100000000000000001000000000000000000000000000000000000000000000000000000000000000000000000000000000000001000000000000010000000000000001000000000000000000000000100000000000001000000000000000000010000000000001
10000000000000000000001000000000000000000010000000000000100000000000000100000000000000000000100000000000000001000000000000000000000000000000000000000000000000000000000000000000000000000000000000001000000000000010000000000000001000000000000000000000000100000000000001000000000000000000010000000000001
10000000000000000000001000000000000000000010000000000000100000000000000100000000000000000000100000000000000001000000000000000000000000000000000000000000000000000000000000000000000000000000000000001000000000000010000000000000001000000000000000000000000100000000000001000000000000000000010000000000001
10000000000000000000001000000000000000000010000000000000100000000000000100000000000000000000100000000000000001000000000000000000000000000000000000000000000000000000000000000000000000000000000000001000000000000010000000000000001000000000000000000000000100000000000001000000000000000000010000000000001
10000000000000000000001000000000000000000010000000000000100000000000000100000000000000000000100000000000000001000000000000000000000000000000000000000000000000000000000000000000000000000000000000001000000000000010000000000000001000000000000000000000000100000000000001000000000000000000010000000000001
10000000000000000000001000000000000000000010000000000000100000000000000100000000000000000000100000000000000001000000000000000000000000000000000000000000000000000000000000000000000000000000000000001000000000000010000000000000001000000000000000000000000100000000000001000000000000000000010000000000001
10000000000000000000001000000000000000000010000000000000100000000000000100000000000000000000100000000000000001000000000000000000000000000000000000000000000000000000000000000000000000000000000000001000000000000010000000000000001000000000000000000000000100000000000001000000000000000000010000000000001
10000000000000000000001000000000000000000010000000000000100000000000000100000000000000000000100000000000000001000000000000000000000000000000000000000000000000000000000000000000000000000000000000001000000000000010000000000000001000000000000000000000000100000000000001000000000000000000010000000000001
10000000000000000000001000000000000000000010000000000000100000000000000100000000000000000000100000000000000001000000000000000000000000000000000000000000000000000000000000000000000000000000000000001000000000000010000000000000001000000000000000000000000100000000000001000000000000000000010000000000001
10000000000000000000001000000000000000000010000000000000100000000000000100000000000000000000100000000000000001000000000000000000000000000000000000000000000000000000000000000000000000000000000000001000000000000010000000000000001000000000000000000000000100000000000001000000000000000000010000000000001
10000000000000000000001000000000000000000010000000000000000000000000000100000000000000000000100000000000000001000000000000000000000000000000000000000000000000000000000000000000000000000000000000001000000000000010000000000000001000000000000000000000000100000000000001000000000000000000010000000000001
10000000000000000000001000000000000000000010000000000000000000000000000100000000000000000000100000000000000001000000000000000000000000000000000000000000000000000000000000000000000000000000000000001000000000000010000000000000001000000000000000000000000100000000000001000000000000000000010000000000001
10000000000000000000001000000000000000000010000000000000000000000000000100000000000000000000100000000000000001000000000000000000000000000000000000000000000000000000000000000000000000000000000000001000000000000010000000000000001000000000000000000000000100000000000001000000000000000000010000000000001
10000000000000000000001000000000000000000010000000000000000000000000000100000000000000000000100000000000000001000000000000000000000000000000000000000000000000000000000000000000000000000000000000001000000000000010000000000000001000000000000000000000000100000000000001000000000000000000010000000000001
10000000000000000000001000000000000000000010000000000000000000000000000100000000000000000000100000000000000001000000000000000000000000000000000000000000000000000000000000000000000000000000000000001000000000000010000000000000001000000000000000000000000100000000000001000000000000000000010000000000001
1111111111000111111111111111111111111111111111111Y111111100000000000000111111111000111111111111111111111111111111111111111111111111111111111111111111111111111111111111111111111111111111111111111111111111111111111111111111111111111111111111111111111111111111111111111111111111111111111111111111111111
10000000000H00000000001000000000000000000010000000000000100000000000000100000000000000000000100000000000000001000000000000000000000000000000000000000000000000000000000000000000000000000000000000001000000000000010000000000000001000000000000000000000000100000000000001000000000000000000010000000000001
1000000000000000000000100000A0000000H0000010000000000000100000000000000100000000000000000000100000000000000001000000000000000000000000000000000000000000000000000000000000000000000000000000000000001000000000000010000000000000001000000000000000000000000100000000000001000000000000000000010000000000001
10H00000000D00000000H01000000000000000000010000000000000100000000000000100000000000000000000100000000000000001000000000000000000000000000000000000000000000000000000000000000000000000000000000000001000000000000010000000000000001000000000000000000000000100000000000001000000000000000000010000000000001
100000000A000A000000001000000000M00000000010000000000000100000000000000000000000000000000000100000000000000001000000000000000000000000000000000000000000000000000000000000000000000000000000000000001000000000000010000000000000001000000000000000000000000100000000000001000000000000000000010000000000001
1Y111111111111111111111000000000000000000010000000000000100000000000000100000000000000000000100000000000000001000000000000000000000000000000000000000000000000000000000000000000000000000000000000001000000000000010000000000000001000000000000000000000000100000000000001000000000000000000010000000000001
1000000000000000000000Y00000H0000000A0000010000000000000100000000000000100000000000000000000100000000000000001000000000000000000000000000000000000000000000000000000000000000000000000000000000000001000000000000010000000000000001000000000000000000000000100000000000001000000000000000000010000000000001
1000000000000000000000Y0000000000000000000Y0000000000000100000000000000100000000000000000000100000000000000001000000000000000000000000000000000000000000000000000000000000000000000000000000000000001000000000000010000000000000001000000000000000000000000100000000000001000000000000000000010000000000001
11111111111111111111111111111111111111111111111111111111111111111111111111111111111111111111111111111111111111111111111111111111111111111111111111111111111111111111111111111111111111111111111111111111111111111111111111111111111111111111111111111111111111111111111111111111111111111111111111111111111