R  1000 600

NO ../xpm/matrix.xpm
SO ../xpm/matrix.xpm
WE ../xpm/matrix.xpm
EA ../xpm/matrix.xpm
S ../xpm/meshok.xpm

F 128 , 128, 128
C 0, 165, 255

11111111111111111111111111111111111111111111111111111111111111111111111111111111111111111111111111111111111111111111111111111111111111111111111111111111111111111111111111111111111111111111111111111111111111111111111111111111111111111111111111111111111111111111111111111111111111111111111111111111111
100000Y0000010000000010000000000000000000010000000000000100000000000000100000000000000000000100000000000000001000000000000000000000000000000000000000000000000000000000000000000000000000000000000001000000000000010000000000000001000000000000000000000000100000000000001000000000000000000010000000000001
10Z00000M0D010000000010000000000000000000010000000000000100000000000000100000000000000000000100000000000000001000000000000000000000000000000000000000000000000000000000000000000000000000000000000001000000000000010000000000000001000000000000000000000000100000000000001000000000000000000010000000000001
10AA00N00000100000000100000000000000000000Y0000000000000100000000000000100000000000000000000100000000000000001000000000000000000000000000000000000000000000000000000000000000000000000000000000000001000000000000010000000000000001000000000000000000000000100000000000001000000000000000000010000000000001
10CA0000CC0010000000010000000010000000000010000000000000100000000000000100000000000000000000100000000000000001000000000000000000000000000000000000000000000000000000000000000000000000000000000000001000000000000010000000000000001000000000000000000000000100000000000001000000000000000000010000000000001
10AA0HVH0H0010000000010000000010000000000010000000000000100000000000000100000000000000000000100000000000000001000000000000000000000000000000000000000000000000000000000000000000000000000000000000001000000000000010000000000000001000000000000000000000000100000000000001000000000000000000010000000000001
1111110111111111Y111111110111111111111111111111110111111111111111111111111111111111111111111111111111111111111111111111111111111111111111111111111111111111111111111111111111111111111111111111111111111111111111111111111111111111111111111111111111111111111111111111111111111111111111111111111111111111
10000000V00010000000010000000010000000000010000000000000100000000000000100000000000000000000100000000000000001000000000000000000000000000000000000000000000000000000000000000000000000000000000000001000000001000000001000000001000000001000000001000000000700000000000001000000000000000000010000000000001
100V0000000010000000010000000010000000000010000000000000100000000000000100000000000000000000100000000000000001000000000000000000000000000000000000000000000000000000000000000000000000000000000000001000000007000000001000000001000000001000000001000000000100000000000001000000000000000000010000000000001
10000000000010000000010000000000000000000010000000000000100000000000000100000000000000000000100000000000000001000000000000000000000000000000000000000000000000000000000000000000000000000000000000001000000001000000001000000001000000001000000001000000000100000000000001000000000000000000000000000000001
10000000V000100000000100000000000000000000100000000000000000000000000001000000000000000000001000000000000000010000000000000000000000000000000000000000000000000000000000000000000000000000000000000070000000010000000010000000010000000070000000010000000001000000000000070000000000000000000000000Z0000001
10V0000V000010000000010000000000000000000010000000000000100000000000000100000000000000000000100000000000000001000000000000000000000000000000000000000000000000000000000000000000000000000000000000001000000001000000001000000001000000001000000001000000000100000000000001000000000000000000000000000000001
10000000000010000000010000000010000000000010000000000000100000000000000100000000000000000000100000000000000001000000000000000000000000000000000000000000000000000000000000000000000000000000000000001000000001000000007000000001000000001000000007000000000100000000000001000000000000000000010000000000001
10000000000010000000010000000010000000000010000000000000100000000000000100000000000000000000100000000000000001000000000000000000000000000000000000000000000000000000000000000000000000000000000000001000000001000000001000000007000000001000000001000000000100000000000001000000000000000000010000000000001
100V00000000100000000011111111111111111111111111111111111000000000000001111111111111111111111111111111111111111111111111111111111111111111111111111111111111111111111111111111111111111111111111111111111111111111111111111111111111111111111111111111111111111111111111111111111111111111111111111111111111
10000000000010000000010000000010000000000010000000000000100000000000000100000000000000000000100000000000000001000000000000000000000000000000000000000000000000000000000000000000000000000000000000001000000000000010000000000000001000000000000000000000000100000000000001000000000000000000010000000000001
10000000000010000000010000000010000000000010000000000000100000000000000100000000000000000000100000000000000001000000000000000000000000000000000000000000000000000000000000000000000000000000000000001000000000000010000000000000001000000000000000000000000100000000000001000000000000000000010000000000001
10000000V00010000000010000000010000000000010000000000000100000000000000100000000000000000000100000000000000001000000000000000000000000000000000000000000000000000000000000000000000000000000000000001000000000000010000000000000001000000000000000000000000100000000000001000000000000000000010000000000001
10000000000010000000010000000010000000000010000000000000100000000000000100000000000000000000100000000000000001000000000000000000000000000000000000000000000000000000000000000000000000000000000000001000000000000010000000000000001000000000000000000000000100000000000001000000000000000000010000000000001
10000000000010000000001000000001000000000000000000000000000000000000000100000000000000000000100000000000000001000000000000000000000000000000000000000000000000000000000000000000000000000000000000001000000000000010000000000000001000000000000000000000000100000000000001000000000000000000010000000000001
10000000000010000000001000000001000000000010000000000000100000000000000100000000000000000000100000000000000001000000000000000000000000000000000000000000000000000000000000000000000000000000000000001000000000000010000000000000001000000000000000000000000100000000000001000000000000000000010000000000001
10000000000010000000001000000001000000000010000000000000100000000000000100000000000000000000100000000000000001000000000000000000000000000000000000000000000000000000000000000000000000000000000000001000000000000010000000000000001000000000000000000000000100000000000001000000000000000000010000000000001
10000000000010000000001000000001000000000010000000000000100000000000000100000000000000000000100000000000000001000000000000000000000000000000000000000000000000000000000000000000000000000000000000001000000000000010000000000000001000000000000000000000000100000000000001000000000000000000010000000000001
10000000000010000000001111111111111111111110000000000000111111111111111111111111111111111111111111111111111111111111111111111111111111111111111111111111111111111111111111111111111111111111111111111111111111111111111111111111111111111111111111111111111111111111111111111111111111111111111111111111111
100000V0000010000000001000000001000000000010000000000000100000000000000100000000000000000000100000000000000001000000000000000000000000000000000000000000000000000000000000000000000000000000000000001000000000000010000000000000001000000000000000000000000100000000000001000000000000000000010000000000001
10000000000010000000001000000001000000000010000000000000100000000000000100000000000000000000100000000000000001000000000000000000000000000000000000000000000000000000000000000000000000000000000000001000000000000010000000000000001000000000000000000000000100000000000001000000000000000000010000000000001
10000000000010000000001000000001000000000010000000000000100000000000000100000000000000000000100000000000000001000000000000000000000000000000000000000000000000000000000000000000000000000000000000001000000000000010000000000000001000000000000000000000000100000000000001000000000000000000010000000000001
10000000000010000000001000000001000000000010000000000000100000000000000100000000000000000000100000000000000001000000000000000000000000000000000000000000000000000000000000000000000000000000000000001000000000000010000000000000001000000000000000000000000100000000000001000000000000000000010000000000001
10000000000010000000001000000001000000000010000000000000100000000000000100000000000000000000100000000000000001000000000000000000000000000000000000000000000000000000000000000000000000000000000000001000000000000010000000000000001000000000000000000000000100000000000001000000000000000000010000000000001
10000000000010000000001000000001000000000010000000000000100000000000000100000000000000000000100000000000000001000000000000000000000000000000000000000000000000000000000000000000000000000000000000001000000000000010000000000000001000000000000000000000000100000000000001000000000000000000010000000000001
10000000000010000000001000000000000000000010000000000000100000000000000100000000000000000000100000000000000001000000000000000000000000000000000000000000000000000000000000000000000000000000000000001000000000000010000000000000001000000000000000000000000100000000000001000000000000000000010000000000001
10000000000010000000001000000001000000000010000000000000100000000000000100000000000000000000100000000000000001000000000000000000000000000000000000000000000000000000000000000000000000000000000000001000000000000010000000000000001000000000000000000000000100000000000001000000000000000000010000000000001
10000000000010000000001111111111111111111110000000000000111111111111111111111111111111111111111111111111111111111111111111111111111111111111111111111111111111111111111111111111111111111111111111111111111111111111111111111111111111111111111111111111111111111111111111111111111111111111111111111111111
10000000000010000000000000000001000000000010000000000000100000000000000100000000000000000000100000000000000001000000000000000000000000000000000000000000000000000000000000000000000000000000000000001000000000000010000000000000001000000000000000000000000100000000000001000000000000000000010000000000001
10000000000010000000001000000001000000000010000000000000100000000000000100000000000000000000100000000000000001000000000000000000000000000000000000000000000000000000000000000000000000000000000000001000000000000010000000000000001000000000000000000000000100000000000001000000000000000000010000000000001
10000000000010000000001000000001000000000010000000000000100000000000000100000000000000000000100000000000000001000000000000000000000000000000000000000000000000000000000000000000000000000000000000001000000000000010000000000000001000000000000000000000000100000000000001000000000000000000010000000000001
10000000000010000000001000000001000000000010000000000000100000000000000100000000000000000000100000000000000001000000000000000000000000000000000000000000000000000000000000000000000000000000000000001000000000000010000000000000001000000000000000000000000100000000000001000000000000000000010000000000001
10000000000000000000011000000010000000000010000000000000100000000000000100000000000000000000100000000000000001000000000000000000000000000000000000000000000000000000000000000000000000000000000000001000000000000010000000000000001000000000000000000000000100000000000001000000000000000000010000000000001
10000000000000000000001000000010000000000010000000000000100000000000000100000000000000000000100000000000000001000000000000000000000000000000000000000000000000000000000000000000000000000000000000001000000000000010000000000000001000000000000000000000000100000000000001000000000000000000010000000000001
10000000000000000000001000000010000000000010000000000000100000000000000100000000000000000000100000000000000001000000000000000000000000000000000000000000000000000000000000000000000000000000000000001000000000000010000000000000001000000000000000000000000100000000000001000000000000000000010000000000001
10000000000000000000001000000000000000000010000000000000100000000000000100000000000000000000100000000000000001000000000000000000000000000000000000000000000000000000000000000000000000000000000000001000000000000010000000000000001000000000000000000000000100000000000001000000000000000000010000000000001
11111111110001111111111111111111111111111110000000000000111111111111111111111111111111111111111111111111111111111111111111111111111111111111111111111111111111111111111111111111111111111111111111111111111111111111111111111111111111111111111111111111111111111111111111111111111111111111111111111111111
10000000000000000000001000000000000000000010000000000000000000000000000100000000000000000000100000000000000001000000000000000000000000000000000000000000000000000000000000000000000000000000000000001000000000000010000000000000001000000000000000000000000100000000000001000000000000000000010000000000001
10000000000000000000001000000000000000000010000000000000100000000000000100000000000000000000100000000000000001000000000000000000000000000000000000000000000000000000000000000000000000000000000000001000000000000010000000000000001000000000000000000000000100000000000001000000000000000000010000000000001
10000000000000000000001000000000000000000010000000000000100000000000000100000000000000000000100000000000000001000000000000000000000000000000000000000000000000000000000000000000000000000000000000001000000000000010000000000000001000000000000000000000000100000000000001000000000000000000010000000000001
10000000000000000000000000000000000000000000000000000000100000000000000100000000000000000000100000000000000001000000000000000000000000000000000000000000000000000000000000000000000000000000000000001000000000000010000000000000001000000000000000000000000100000000000001000000000000000000010000000000001
10000000000000000000001000000000000000000010000000000000100000000000000100000000000000000000100000000000000001000000000000000000000000000000000000000000000000000000000000000000000000000000000000001000000000000010000000000000001000000000000000000000000100000000000001000000000000000000010000000000001
10000000000000000000001000000000000000000010000000000000100000000000000100000000000000000000100000000000000001000000000000000000000000000000000000000000000000000000000000000000000000000000000000001000000000000010000000000000001000000000000000000000000100000000000001000000000000000000010000000000001
100000000000000000000011111111111111111111100000000000001000000000000001111111111111111111111111111111111111111111111111111111111111111111111111111111111111111111111111111111111111111111111111111111111111111111111111111111111111111111111111111111111111111111111111111111111111111111111111111111111111
10000000000000000000001000000000000000000010000000000000100000000000000100000000000000000000100000000000000001000000000000000000000000000000000000000000000000000000000000000000000000000000000000001000000000000010000000000000001000000000000000000000000100000000000001000000000000000000010000000000001
10000000000000000000001000000000000000000010000000000000100000000000000100000000000000000000100000000000000001000000000000000000000000000000000000000000000000000000000000000000000000000000000000001000000000000010000000000000001000000000000000000000000100000000000001000000000000000000010000000000001
10000000000000000000001000000000000000000010000000000000100000000000000100000000000000000000100000000000000001000000000000000000000000000000000000000000000000000000000000000000000000000000000000001000000000000010000000000000001000000000000000000000000100000000000001000000000000000000010000000000001
10000000000000000000001000000000000000000010000000000000100000000000000100000000000000000000100000000000000001000000000000000000000000000000000000000000000000000000000000000000000000000000000000001000000000000010000000000000001000000000000000000000000100000000000001000000000000000000010000000000001
10000000000000000000001000000000000000000010000000000000100000000000000100000000000000000000100000000000000001000000000000000000000000000000000000000000000000000000000000000000000000000000000000001000000000000010000000000000001000000000000000000000000100000000000001000000000000000000010000000000001
10000000000000000000001000000000000000000010000000000000100000000000000100000000000000000000100000000000000001000000000000000000000000000000000000000000000000000000000000000000000000000000000000001000000000000010000000000000001000000000000000000000000100000000000001000000000000000000010000000000001
10000000000000000000001000000000000000000010000000000000100000000000000100000000000000000000100000000000000001000000000000000000000000000000000000000000000000000000000000000000000000000000000000001000000000000010000000000000001000000000000000000000000100000000000001000000000000000000010000000000001
100000000000000000000011111111111111111111100000000000001111111101111111111111111111111111111111111111111111111111111111111111111111111111111111111111111111111111111111111111111111111111111111111111111111111111111111111111111111111111111111111111111111111111111111111111111111111111111111111111111111
10000000000000000000001000000000000000000010000000000000100000000000000100000000000000000000100000000000000001000000000000000000000000000000000000000000000000000000000000000000000000000000000000001000000000000010000000000000001000000000000000000000000100000000000001000000000000000000010000000000001
10000000000000000000001000000000000000000010000000000000100000000000000100000000000000000000100000000000000001000000000000000000000000000000000000000000000000000000000000000000000000000000000000001000000000000010000000000000001000000000000000000000000100000000000001000000000000000000010000000000001
10000000000000000000001000000000000000000010000000000000100000000000000100000000000000000000100000000000000001000000000000000000000000000000000000000000000000000000000000000000000000000000000000001000000000000010000000000000001000000000000000000000000100000000000001000000000000000000010000000000001
10000000000000000000001000000000000000000010000000000000100000000000000100000000000000000000100000000000000001000000000000000000000000000000000000000000000000000000000000000000000000000000000000001000000000000010000000000000001000000000000000000000000100000000000001000000000000000000010000000000001
10000000000000000000001000000000000000000010000000000000100000000000000100000000000000000000100000000000000001000000000000000000000000000000000000000000000000000000000000000000000000000000000000001000000000000010000000000000001000000000000000000000000100000000000001000000000000000000010000000000001
10000000000000000000001000000000000000000010000000000000100000000000000100000000000000000000100000000000000001000000000000000000000000000000000000000000000000000000000000000000000000000000000000001000000000000010000000000000001000000000000000000000000100000000000001000000000000000000010000000000001
10000000000000000000001000000000000000000010000000000000100000000000000100000000000000000000100000000000000001000000000000000000000000000000000000000000000000000000000000000000000000000000000000001000000000000010000000000000001000000000000000000000000100000000000001000000000000000000010000000000001
10000000000000000000001000000000000000000010000000000000100000000000000100000000000000000000100000000000000001000000000000000000000000000000000000000000000000000000000000000000000000000000000000001000000000000010000000000000001000000000000000000000000100000000000001000000000000000000010000000000001
10000000000000000000001000000000000000000010000000000000100000000000000100000000000000000000100000000000000001000000000000000000000000000000000000000000000000000000000000000000000000000000000000001000000000000010000000000000001000000000000000000000000100000000000001000000000000000000010000000000001
10000000000000000000001000000000000000000010000000000000100000000000000100000000000000000000100000000000000001000000000000000000000000000000000000000000000000000000000000000000000000000000000000001000000000000010000000000000001000000000000000000000000100000000000001000000000000000000010000000000001
10000000000000000000001000000000000000000010000000000000100000000000000100000000000000000000100000000000000001000000000000000000000000000000000000000000000000000000000000000000000000000000000000001000000000000010000000000000001000000000000000000000000100000000000001000000000000000000010000000000001
10000000000000000000001000000000000000000010000000000000100000000000000100000000000000000000100000000000000001000000000000000000000000000000000000000000000000000000000000000000000000000000000000001000000000000010000000000000001000000000000000000000000100000000000001000000000000000000010000000000001
10000000000000000000001000000000000000000010000000000000100000000000000100000000000000000000100000000000000001000000000000000000000000000000000000000000000000000000000000000000000000000000000000001000000000000010000000000000001000000000000000000000000100000000000001000000000000000000010000000000001
10000000000000000000001000000000000000000010000000000000100000000000000100000000000000000000100000000000000001000000000000000000000000000000000000000000000000000000000000000000000000000000000000001000000000000010000000000000001000000000000000000000000100000000000001000000000000000000010000000000001
10000000000000000000001000000000000000000010000000000000100000000000000100000000000000000000100000000000000001000000000000000000000000000000000000000000000000000000000000000000000000000000000000001000000000000010000000000000001000000000000000000000000100000000000001000000000000000000010000000000001
10000000000000000000001000000000000000000010000000000000100000000000000100000000000000000000100000000000000001000000000000000000000000000000000000000000000000000000000000000000000000000000000000001000000000000010000000000000001000000000000000000000000100000000000001000000000000000000010000000000001
10000000000000000000001000000000000000000010000000000000100000000000000100000000000000000000100000000000000001000000000000000000000000000000000000000000000000000000000000000000000000000000000000001000000000000010000000000000001000000000000000000000000100000000000001000000000000000000010000000000001
10000000000000000000001000000000000000000010000000000000000000000000000100000000000000000000100000000000000001000000000000000000000000000000000000000000000000000000000000000000000000000000000000001000000000000010000000000000001000000000000000000000000100000000000001000000000000000000010000000000001
10000000000000000000001000000000000000000010000000000000000000000000000100000000000000000000100000000000000001000000000000000000000000000000000000000000000000000000000000000000000000000000000000001000000000000010000000000000001000000000000000000000000100000000000001000000000000000000010000000000001
10000000000000000000001000000000000000000010000000000000000000000000000100000000000000000000100000000000000001000000000000000000000000000000000000000000000000000000000000000000000000000000000000001000000000000010000000000000001000000000000000000000000100000000000001000000000000000000010000000000001
10000000000000000000001000000000000000000010000000000000000000000000000100000000000000000000100000000000000001000000000000000000000000000000000000000000000000000000000000000000000000000000000000001000000000000010000000000000001000000000000000000000000100000000000001000000000000000000010000000000001
10000000000000000000001000000000000000000010000000000000000000000000000100000000000000000000100000000000000001000000000000000000000000000000000000000000000000000000000000000000000000000000000000001000000000000010000000000000001000000000000000000000000100000000000001000000000000000000010000000000001
11111111110001111111111111111111111111111111111113111111100000000000000111111111000111111111111111111111111111111111111111111111111111111111111111111111111111111111111111111111111111111111111111111111111111111111111111111111111111111111111111111111111111111111111111111111111111111111111111111111111
10000000000H00000000001000000000000000000010000000000000100000000000000100000000000000000000100000000000000001000000000000000000000000000000000000000000000000000000000000000000000000000000000000001000000000000010000000000000001000000000000000000000000100000000000001000000000000000000010000000000001
1000000000000000000000100000A0000000H00000100C000C000C00100000000000000100000000000000000000100000000000000001000000000000000000000000000000000000000000000000000000000000000000000000000000000000001000000000000010000000000000001000000000000000000000000100000000000001000000000000000000010000000000001
10H00000000D00000000H010000000000000000000100C000C000C00100000000000000100000000000000000000100000000000000001000000000000000000000000000000000000000000000000000000000000000000000000000000000000001000000000000010000000000000001000000000000000000000000100000000000001000000000000000000010000000000001
100000000A000A000000001000000000M000000000100C000C000C00100000000000000000000000000000000000100000000000000001000000000000000000000000000000000000000000000000000000000000000000000000000000000000001000000000000010000000000000001000000000000000000000000100000000000001000000000000000000010000000000001
131111111111111111111110000000000000000000100C000C000C00100000000000000100000000000000000000100000000000000001000000000000000000000000000000000000000000000000000000000000000000000000000000000000001000000000000010000000000000001000000000000000000000000100000000000001000000000000000000010000000000001
1000000A00000H00000000700000H0000000A000001000A0H0A0H000100000000000000100000000000000000000100000000000000001000000000000000000000000000000000000000000000000000000000000000000000000000000000000001000000000000010000000000000001000000000000000000000000100000000000001000000000000000000010000000000001
1000H00000A00000A000007000000000000000000070000000000000100000000000000100000000000000000000100000000000000001000000000000000000000000000000000000000000000000000000000000000000000000000000000000001000000000000010000000000000001000000000000000000000000100000000000001000000000000000000010000000000001
11111111111111111111111111111111111111111111111111111111111111111111111111111111111111111111111111111111111111111111111111111111111111111111111111111111111111111111111111111111111111111111111111111111111111111111111111111111111111111111111111111111111111111111111111111111111111111111111111111111111