R  1000 600

NO ./xpm/matrix.xpm
SO ./xpm/matrix.xpm
WE ./xpm/matrix.xpm
EA ./xpm/matrix.xpm
S ./xpm/mmmatrixxx.xpm

F 128 , 128, 128
C 0, 165, 255

11111111111111111111111111111111111111111111111111111111111111111111111111111111111111111111111111111111111111111111111111111111111111111111111111111111111111111111111111111111111111111111111111111111111111111111111111111111111111111111111111111111111111111111111111111111111111111111111111111111111
100000Y0000010000000010000000000000000000010000000000000100000000000000100000000000000000000100000000000000001000000000000000000000000000000000000000000000000000000000000000000000000000000000000001000000000000010000000000000001000000000000000000000000100000000000001000000000000000000010000000000001
10000000000010HCCCCA0100C0H0A0C0H0A0C0H0A010000000000000100000000000000100H0000V00000V0000H0100000000000000001000000000000000000000000000000000000000000000000000000000000000000000000000000000000001000000000000010000000000000001000000000000000000000000100000000000001000000000000000000010000000000001
100000N0000010H0CC0A0100000000000000000000Y000000C000000100000000000000100000000000000000000100000000000000001000000000000000000000000000000000000000000000000000000000000000000000000000000000000001000000000000010000000000000001000000000000000000000000100000000000001000000000000000000010000000000001
10000000000010HCCCCA0100000000100000C0000010000000000000100000000000000100C000000000000000C0100000000000000001000000000000000000000000000000000000000000000000000000000000000000000000000000000000001000000000000010000000000000001000000000000000000000000100000000000001000000000000000000010000000000001
10000000000010000000010000000010000000000010000000000000100000000000000100000000000000000000100000000000000001000000000000000000000000000000000000000000000000000000000000000000000000000000000000001000000000000010000000000000001000000000000000000000000100000000000001000000000000000000010000000000001
1111118111111111311111111V1111111111V111111111111V11111111111111111111111111111111V111111111111111111111111111111111111111111111111111111111111111111111111111111111111111111111111111111111111111111111111111111111111111111111111111111111111111111111111111111111111111111111111111111111111111111111111
10000000V00010000000010000000010000000000010000000000000100000000000000100000000000000000000100000000000000001000000000000000000000000000000000000000000000000000000000000000000000000000000000000001000000001000000001000000001000000001000000001000000000700000000000001000000000000000000010000000000001
10000000000010000000010000000010000000000010000000000000100000000000000100000000000000000000100000000000000001000000000000000000000000000000000000000000000000000000000000000000000000000000000000001000000007000000001000000001000000001000000001000000000100000000000001000000000000000000010000000000001
100800002000100000000100000000V000000000001000000C000000100000000000000100000000000000000000100000000000000001000000000000000000000000000000000000000000000000000000000000000000000000000000000000001000000001000000001000000001000000001000000001000000000100000000000001000000000000000000000000000000001
100008000000100000000100000000V00000V000001000000H0000000000000000000001000000000000000000001000000000000000010000000000000000000000000000000000000000000000000000000000000000000000000000000000000070000000010000000010000000010000000070000000010000000001000000000000030000000000000000000000000Z0000001
10V008000000100000000100000000V000000000001000000A000000100000000000000100000000000000000000100000000000000001000000000000000000000000000000000000000000000000000000000000000000000000000000000000001000000001000000001000000001000000001000000001000000000100000000000001000000000000000000000000000000001
10000800000010000000010000000010000000000010000000000000100000000000000100000000000000000000100000000000000001000000000000000000000000000000000000000000000000000000000000000000000000000000000000001000000001000000007000000001000000001000000007000000000100000000000001000000000000000000010000000000001
10000800000010000000010000000010000000000010000000000000100000000000000100000000000000000000100000000000000001000000000000000000000000000000000000000000000000000000000000000000000000000000000000001000000001000000001000000007000000001000000001000000000100000000000001000000000000000000010000000000001
1000080000001000000000V1111111111111111111111111111111111000000000000001111111111181111111111111111111111111111111111111111111111111111111111111111111111111111111111111111111111111111111111111111111111111111111111111111111111111111111111111111111111111111111111111111111111111111111111111111111111111
10000000000010000000010000000010000000000010000000000000100000000000000100000000000000000000100000000000000001000000000000000000000000000000000000000000000000000000000000000000000000000000000000001000000000000010000000000000001000000000000000000000000100000000000001000000000000000000010000000000001
1000000020001000000001000V000010000000000010000000000000100000000000000100000000000000000000100000000000000001000000000000000000000000000000000000000000000000000000000000000000000000000000000000001000000000000010000000000000001000000000000000000000000100000000000001000000000000000000010000000000001
10020000000010000000010000000010000000000010000000000000100000000000000100000000000000000000100000000000000001000000000000000000000000000000000000000000000000000000000000000000000000000000000000001000000000000010000000000000001000000000000000000000000100000000000001000000000000000000010000000000001
1000000000001000000001000V000011000000000010000000000000100000000000000100000000000000000000100000000000000001000000000000000000000000000000000000000000000000000000000000000000000000000000000000001000000000000010000000000000001000000000000000000000000100000000000001000000000000000000010000000000001
100000000000100000000110000000070000000000V0000000000000V00000000000000100000000000000000000100000000000000001000000000000000000000000000000000000000000000000000000000000000000000000000000000000001000000000000010000000000000001000000000000000000000000100000000000001000000000000000000010000000000001
1000000000001000000000100000V001000000000010000000000000100000000000000100000000000000000000100000000000000001000000000000000000000000000000000000000000000000000000000000000000000000000000000000001000000000000010000000000000001000000000000000000000000100000000000001000000000000000000010000000000001
1000000002001000000000100000000100000000001000V000000000100000000000000100000000000000000000100000000000000001000000000000000000000000000000000000000000000000000000000000000000000000000000000000001000000000000010000000000000001000000000000000000000000100000000000001000000000000000000010000000000001
1000000000001000000000100V000001000000000010000000000000100000000000000100000000000000000000100000000000000001000000000000000000000000000000000000000000000000000000000000000000000000000000000000001000000000000010000000000000001000000000000000000000000100000000000001000000000000000000010000000000001
10000020000010000000001111111111111111111110000000000000111111111111111111111111118111111111111111111111111111111111111111111111111111111111111111111111111111111111111111111111111111111111111111111111111111111111111111111111111111111111111111111111111111111111111111111111111111111111111111111111111
10000000000010000000001000000001000000000010000000000000100000000000000100000000000000000000100000000000000001000000000000000000000000000000000000000000000000000000000000000000000000000000000000001000000000000010000000000000001000000000000000000000000100000000000001000000000000000000010000000000001
100000000000100000000010000C00010000A0000010000000000000100000000000000100000000000000000000100000000000000001000000000000000000000000000000000000000000000000000000000000000000000000000000000000001000000000000010000000000000001000000000000000000000000100000000000001000000000000000000010000000000001
100000000000100000000010000C0001000000000010000000000000100000000000000100000000000000000000100000000000000001000000000000000000000000000000000000000000000000000000000000000000000000000000000000001000000000000010000000000000001000000000000000000000000100000000000001000000000000000000010000000000001
100000000000100000000010000C0001000000000010000000000000100000000000000100000000000000000000100000000000000001000000000000000000000000000000000000000000000000000000000000000000000000000000000000001000000000000010000000000000001000000000000000000000000100000000000001000000000000000000010000000000001
100000000000100000000030000C0001000000000010000000000000100000000000000100000000000000000000100000000000000001000000000000000000000000000000000000000000000000000000000000000000000000000000000000001000000000000010000000000000001000000000000000000000000100000000000001000000000000000000010000000000001
100000000000100000000010000C000100000000001000000000V000100000000000000100000000000000000000100000000000000001000000000000000000000000000000000000000000000000000000000000000000000000000000000000001000000000000010000000000000001000000000000000000000000100000000000001000000000000000000010000000000001
100000000000100000000010000C000V0000A0000010000000000000100000000000000100000000000000000000100000000000000001000000000000000000000000000000000000000000000000000000000000000000000000000000000000001000000000000010000000000000001000000000000000000000000100000000000001000000000000000000010000000000001
10000000000010000000001000000001000000000010000000000000100000000000000100000000000000000000100000000000000001000000000000000000000000000000000000000000000000000000000000000000000000000000000000001000000000000010000000000000001000000000000000000000000100000000000001000000000000000000010000000000001
1000000000001000000000111111111111111111111000000000000011111111111111111181111111V111111811111111111111111111111111111111111111111111111111111111111111111111111111111111111111111111111111111111111111111111111111111111111111111111111111111111111111111111111111111111111111111111111111111111111111111
1000000000001000000000V000000001000000000010000000000000100000000000000100000000000000000000100000000000000001000000000000000000000000000000000000000000000000000000000000000000000000000000000000001000000000000010000000000000001000000000000000000000000100000000000001000000000000000000010000000000001
100000000000100000000010000000010C00HA00C010000000000000100000000000000100000000000000000000100000000000000001000000000000000000000000000000000000000000000000000000000000000000000000000000000000001000000000000010000000000000001000000000000000000000000100000000000001000000000000000000010000000000001
1000000000001000000000100000000100000000001000V000000000100000000000000100000000000000000000100000000000000001000000000000000000000000000000000000000000000000000000000000000000000000000000000000001000000000000010000000000000001000000000000000000000000100000000000001000000000000000000010000000000001
100000000000100000000010000000010000000000V0000000000000100000000000000100000000000000000000100000000000000001000000000000000000000000000000000000000000000000000000000000000000000000000000000000001000000000000010000000000000001000000000000000000000000100000000000001000000000000000000010000000000001
10000000000000000000001000000010000000000010000000000000100000000000000100000000000000000000100000000000000001000000000000000000000000000000000000000000000000000000000000000000000000000000000000001000000000000010000000000000001000000000000000000000000100000000000001000000000000000000010000000000001
10000000000000000000001000000010000000000010000000000000100000000000000100000000000000000000100000000000000001000000000000000000000000000000000000000000000000000000000000000000000000000000000000001000000000000010000000000000001000000000000000000000000100000000000001000000000000000000010000000000001
10000000000000000000001000000010000000000010000000000000100000000000000100000000000000000000100000000000000001000000000000000000000000000000000000000000000000000000000000000000000000000000000000001000000000000010000000000000001000000000000000000000000100000000000001000000000000000000010000000000001
100000000000000000000010000000V0000000000010000000000000100000000000000100000000000000000000100000000000000001000000000000000000000000000000000000000000000000000000000000000000000000000000000000001000000000000010000000000000001000000000000000000000000100000000000001000000000000000000010000000000001
11111111110001111111111111111111111111111110000000000000111111111111111111V11111118111111V11111111111111111111111111111111111111111111111111111111111111111111111111111111111111111111111111111111111111111111111111111111111111111111111111111111111111111111111111111111111111111111111111111111111111111
10000000000000000000001000000000000000000010000000000000000000000000000100000000000000000000100000000000000001000000000000000000000000000000000000000000000000000000000000000000000000000000000000001000000000000010000000000000001000000000000000000000000100000000000001000000000000000000010000000000001
100000000000000000000010000000000V0000000010000000000000100000000000000100000000000000000000100000000000000001000000000000000000000000000000000000000000000000000000000000000000000000000000000000001000000000000010000000000000001000000000000000000000000100000000000001000000000000000000010000000000001
100000000000000000000010000V0000000000000010000000000000100000000000000100000000000000000000100000000000000001000000000000000000000000000000000000000000000000000000000000000000000000000000000000001000000000000010000000000000001000000000000000000000000100000000000001000000000000000000010000000000001
1000000000000000000000V0000000000000000000V0000000000000100000000000000100000000000000000000100000000000000001000000000000000000000000000000000000000000000000000000000000000000000000000000000000001000000000000010000000000000001000000000000000000000000100000000000001000000000000000000010000000000001
100000000000000000000010000000000V0000000010000000000000100000000000000100000000000000000000100000000000000001000000000000000000000000000000000000000000000000000000000000000000000000000000000000001000000000000010000000000000001000000000000000000000000100000000000001000000000000000000010000000000001
100000000000000000000010000000000000000000100000V0000000100000000000000100000000000000000000100000000000000001000000000000000000000000000000000000000000000000000000000000000000000000000000000000001000000000000010000000000000001000000000000000000000000100000000000001000000000000000000010000000000001
100000000000000000000011111111111111111111100000000000001000000000000001111111111181111111111111111111111111111111111111111111111111111111111111111111111111111111111111111111111111111111111111111111111111111111111111111111111111111111111111111111111111111111111111111111111111111111111111111111111111
1000000000000000000000000V000000000000000010000000000000100000000000000100000000000000000000100000000000000001000000000000000000000000000000000000000000000000000000000000000000000000000000000000001000000000000010000000000000001000000000000000000000000100000000000001000000000000000000010000000000001
1000000000000000000000000000000000000000V01000000000C000100000000000000100000000000000000000100000000000000001000000000000000000000000000000000000000000000000000000000000000000000000000000000000001000000000000010000000000000001000000000000000000000000100000000000001000000000000000000010000000000001
1000000000000000000000000000000000V000000010000000000000100000000000000100000000000000000000100000000000000001000000000000000000000000000000000000000000000000000000000000000000000000000000000000001000000000000010000000000000001000000000000000000000000100000000000001000000000000000000010000000000001
10000000000000000000000000000V00000000V000V0000000000000100000000000000100000000000000000000100000000000000001000000000000000000000000000000000000000000000000000000000000000000000000000000000000001000000000000010000000000000001000000000000000000000000100000000000001000000000000000000010000000000001
1000000000000000000000000000000000V000000010000000000000100000000000000100000000000000000000100000000000000001000000000000000000000000000000000000000000000000000000000000000000000000000000000000001000000000000010000000000000001000000000000000000000000100000000000001000000000000000000010000000000001
1000000000000000000000000000000000000000V01000V000000000100000000000000100000000000000000000100000000000000001000000000000000000000000000000000000000000000000000000000000000000000000000000000000001000000000000010000000000000001000000000000000000000000100000000000001000000000000000000010000000000001
1000000000000000000000000V000000000000000010000000000000100000000000000100000000000000000000100000000000000001000000000000000000000000000000000000000000000000000000000000000000000000000000000000001000000000000010000000000000001000000000000000000000000100000000000001000000000000000000010000000000001
1000000000000000000000111111111111111111111000000000V00011111111V1111111111111111181111111111111111111111111111111111111111111111111111111111111111111111111111111111111111111111111111111111111111111111111111111111111111111111111111111111111111111111111111111111111111111111111111111111111111111111111
10000000000000000000001000000000000000000010000000000000100000000000000100000000000000000000100000000000000001000000000000000000000000000000000000000000000000000000000000000000000000000000000000001000000000000010000000000000001000000000000000000000000100000000000001000000000000000000010000000000001
10000000000000000000001000000000000000000010000000000000100000000000000100000000000000000000100000000000000001000000000000000000000000000000000000000000000000000000000000000000000000000000000000001000000000000010000000000000001000000000000000000000000100000000000001000000000000000000010000000000001
100000000000000000000010000000000000000000100C0000000000100000000000000100000000000000000000100000000000000001000000000000000000000000000000000000000000000000000000000000000000000000000000000000001000000000000010000000000000001000000000000000000000000100000000000001000000000000000000010000000000001
10000000000000000000001000000000000000000010000000000000100000000000000100000000000000000000100000000000000001000000000000000000000000000000000000000000000000000000000000000000000000000000000000001000000000000010000000000000001000000000000000000000000100000000000001000000000000000000010000000000001
10000000000000000000001000000000000000000010000000000000100000000000000100000000000000000000100000000000000001000000000000000000000000000000000000000000000000000000000000000000000000000000000000001000000000000010000000000000001000000000000000000000000100000000000001000000000000000000010000000000001
1000000000000000000000100000000000000000001000000000V000100000000000000100000000000000000000100000000000000001000000000000000000000000000000000000000000000000000000000000000000000000000000000000001000000000000010000000000000001000000000000000000000000100000000000001000000000000000000010000000000001
10000000000000000000001000000000000000000010000000000000100000000000000100000000000000000000100000000000000001000000000000000000000000000000000000000000000000000000000000000000000000000000000000001000000000000010000000000000001000000000000000000000000100000000000001000000000000000000010000000000001
1000000000000000000000100000000000000000001000V000000000100000000000000100000000000000000000100000000000000001000000000000000000000000000000000000000000000000000000000000000000000000000000000000001000000000000010000000000000001000000000000000000000000100000000000001000000000000000000010000000000001
10000000000000000000001000000000000000000010000000000000100000000000000100000000000000000000100000000000000001000000000000000000000000000000000000000000000000000000000000000000000000000000000000001000000000000010000000000000001000000000000000000000000100000000000001000000000000000000010000000000001
10000000000000000000001000000000000000000010000000C00000100000000000000100000000000000000000100000000000000001000000000000000000000000000000000000000000000000000000000000000000000000000000000000001000000000000010000000000000001000000000000000000000000100000000000001000000000000000000010000000000001
1000000000000000000000100000000000000000001000V000000000100000000000000100000000000000000000100000000000000001000000000000000000000000000000000000000000000000000000000000000000000000000000000000001000000000000010000000000000001000000000000000000000000100000000000001000000000000000000010000000000001
10000000000000000000001000000000000000000010000000000000100000000000000100000000000000000000100000000000000001000000000000000000000000000000000000000000000000000000000000000000000000000000000000001000000000000010000000000000001000000000000000000000000100000000000001000000000000000000010000000000001
10000000000000000000001000000000000000000010000000000V00100000000000000100000000000000000000100000000000000001000000000000000000000000000000000000000000000000000000000000000000000000000000000000001000000000000010000000000000001000000000000000000000000100000000000001000000000000000000010000000000001
100000000000000000000010000000000000000000100000C0000000100000000000000100000000000000000000100000000000000001000000000000000000000000000000000000000000000000000000000000000000000000000000000000001000000000000010000000000000001000000000000000000000000100000000000001000000000000000000010000000000001
10000000000000000000001000000000000000000010000000000000100000000000000100000000000000000000100000000000000001000000000000000000000000000000000000000000000000000000000000000000000000000000000000001000000000000010000000000000001000000000000000000000000100000000000001000000000000000000010000000000001
100000000000000000000010000000000000000000100V000000C000100000000000000100000000000000000000100000000000000001000000000000000000000000000000000000000000000000000000000000000000000000000000000000001000000000000010000000000000001000000000000000000000000100000000000001000000000000000000010000000000001
10000000000000000000001000000000000000000010000000000000100000000000000100000000000000000000100000000000000001000000000000000000000000000000000000000000000000000000000000000000000000000000000000001000000000000010000000000000001000000000000000000000000100000000000001000000000000000000010000000000001
1000000000000000000000100000000000000000001000000V000000000000000000000100000000000000000000100000000000000001000000000000000000000000000000000000000000000000000000000000000000000000000000000000001000000000000010000000000000001000000000000000000000000100000000000001000000000000000000010000000000001
100000000000000000000010000000000000000000100000000000V0000000000000000100000000000000000000100000000000000001000000000000000000000000000000000000000000000000000000000000000000000000000000000000001000000000000010000000000000001000000000000000000000000100000000000001000000000000000000010000000000001
10000000000000000000001000000000000000000010000000000000000000000000000100000000000000000000100000000000000001000000000000000000000000000000000000000000000000000000000000000000000000000000000000001000000000000010000000000000001000000000000000000000000100000000000001000000000000000000010000000000001
100000000000000000000010000000000000000000100V000000V000000000000000000100000000000000000000100000000000000001000000000000000000000000000000000000000000000000000000000000000000000000000000000000001000000000000010000000000000001000000000000000000000000100000000000001000000000000000000010000000000001
10000000000000000000001000000000000000000010000000000000000000000000000100000000000000000000100000000000000001000000000000000000000000000000000000000000000000000000000000000000000000000000000000001000000000000010000000000000001000000000000000000000000100000000000001000000000000000000010000000000001
11111111110001111111111111111111111111111111111113111111100000000000000111111111VVV111111111111111111111111111111111111111111111111111111111111111111111111111111111111111111111111111111111111111111111111111111111111111111111111111111111111111111111111111111111111111111111111111111111111111111111111
10000000000H00000000001000000000000000000010000000000000100000000000000100000000000000000000100000000000000001000000000000000000000000000000000000000000000000000000000000000000000000000000000000001000000000000010000000000000001000000000000000000000000100000000000001000000000000000000010000000000001
1000000000000000000000100000A0000000H00000100C000C000C00100000000000000100000000000000000000100000000000000001000000000000000000000000000000000000000000000000000000000000000000000000000000000000001000000000000010000000000000001000000000000000000000000100000000000001000000000000000000010000000000001
10H00000000D00000000H010000000000000000000100C000C000C00100000000000000100000000000000000000100000000000000001000000000000000000000000000000000000000000000000000000000000000000000000000000000000001000000000000010000000000000001000000000000000000000000100000000000001000000000000000000010000000000001
100000000A000A000000001000000000M000000000100C000C000C00100000000000000V00000000000000000000100000000000000001000000000000000000000000000000000000000000000000000000000000000000000000000000000000001000000000000010000000000000001000000000000000000000000100000000000001000000000000000000010000000000001
131111111111111111111110000000000000000000100C000C000C00100000000000000100000000000000000000100000000000000001000000000000000000000000000000000000000000000000000000000000000000000000000000000000001000000000000010000000000000001000000000000000000000000100000000000001000000000000000000010000000000001
1000000A00000H00000000700000H0000000A000001000A0H0A0H000100000000000000100000000000000000000100000000000000001000000000000000000000000000000000000000000000000000000000000000000000000000000000000001000000000000010000000000000001000000000000000000000000100000000000001000000000000000000010000000000001
1000H00000A00000A000007000000000000000000070000000000000100000000000000100000000000000000000100000000000000001000000000000000000000000000000000000000000000000000000000000000000000000000000000000001000000000000010000000000000001000000000000000000000000100000000000001000000000000000000010000000000001
11111111111111111111111111111111111111111111111111111111111111111111111111111111111111111111111111111111111111111111111111111111111111111111111111111111111111111111111111111111111111111111111111111111111111111111111111111111111111111111111111111111111111111111111111111111111111111111111111111111111