R  800 600

NO ../xpm/oboi.xpm
SO ../xpm/oboi2.xpm
WE ../xpm/oboi5.xpm
EA ../xpm/oboi3.xpm
S ../xpm/meshok.xpm

F 128, 128, 128
C 0, 165, 255

111111111111111111111
120000000000000000021
100000000000000000001
1000200000E0000020001
100000000000000000001
120000000000000000021
111111111111111111111