R  1000 600

NO ./xpm/matrix.xpm
SO ./xpm/matrix.xpm
WE ./xpm/matrix.xpm
EA ./xpm/matrix.xpm
S ./xpm/mmmatrixxx.xpm

F 128 , 128, 128
C 0, 165, 255

11111111111111111111111111111111111111111111111111111111111111111111111111111111111111111111111111111111111111111111111111111111111111111111111111111111111111111111111111111111111111111111111111111111111111111111111111111111111111111111111111111111111111111111111111111111111111111111111111111111111
100000Y00000100000000100000000000000000000100000000000001C000000000000C10000000000000000000010000000000000000100000000000000000000000000000000000000000000000000000000000000000000000000000000000000700000000000001000000000000000100000000000000000000000010000000000000100000000000000000001A0000000000H1
10000000000010HCCCCA0100C0H0A0C0H0A0C0H0A010000000000000100A0H0C0A0H0C0100H0000V00000V0000H010000000000000000100A00H00C00C00H00000000000000000000000000000000000000000000000000000000000A000000000007000000000000010000000000000001000000000000000000000000100000000000001000000000000000000010000CCC000001
100000N0000010H0CC0A0100000000000000000000V000000C000000100A0H0C0A0H0C0100000000000000000000V00000000000000003000000000000000000000C000C0000C00000000C000000000000C000000000C0000000000000000000000070000000000000V000000000000000V000000000000000000000000V0000000000000V0000000000000000000V0000CCC000001
10000000000010HCCCCA0100000000100000C000001000000000000010A0H0C0A0H0C77100C000000000000000C010000000000000000100H00A00C00C00A00000000000000000000000000000000000000000000000000000000000H000000000007000000000000010000000000000001000000000000000000000000100000000000001000000000000000000010000CCC000001
100000000000100000000100000000100000000000100000000000001CA0H0C0A0H0C7V30000000000000000000010000000000000000100000000000000000000000000000000000000000000000000000000000000000000000000000000000000700000000000001000000000000000100000000000000000000000010000000000000100000000000000000001H0000000000A1
1111100011111111311111111V1111111111V111111111111V11111111111111111111111111111111V111111111111V11111111111V11111111111111111111111111111111111111111111111111111111111111111111111111111111111111111111311111111111111111111111111111111111111111111111111111111111111111111111111111111111111111111111111
10000000000010000000010000000010000000000010000000000000100000000000000100000000000000000000100000000000000001000000000000000000000000000000000000000000000000000000000000000000000000000000000000001000000001000000001000000001000000001000000001000000000700000000000001000000000000000000010000000000001
10000000000010000000010000000010000000000010000000000000100000000000000100000000000000000000100000000000000001000000000000000000000000000000000000000000000000000000000000000000000000000V00000000001000000007000000001000000001000000001000000001000000000100000000000001000000000000000000010000000000001
100000000000100000000100000000V000000000001000000C00000010000000000000010000000000000000000010000000A00000000100000000000000000000000000000000000000000V000000000000000000000000000000000000000000001000000001000000001000000001000000001000000001000000000100000000000001000000000000000000000000000000001
100000000000100000000100000000V00000V000001000000H00000000000000000000010000000000000000000010000000C00000000V0000000000000000000000000V00000000000000000000000000000V00000000000000000000000000000070000000010000000010000000010000000070000000010000000001000000000000030000000000000000000000000Z0000001
100000000000100000000100000000V000000000001000000A00000010000000000000010000000000000000000010000000H00000000100000000000000000000000000000000000000000V000000000000000000000000000000000000000000001000000001000000001000000001000000001000000001000000000100000000000001000000000000000000000000000000001
10000000000010000000010000000010000000000010000000000000100000000000000100000000000000000000100000000000000001000000000000000000000000000000000000000000000000000000000000000000000000000V00000000001000000001000000007000000001000000001000000007000000000100000000000001000000000000000000010000000000001
10000000000010000000010000000010000000000010000000000000100000000000000100000000000000000000100000000000000001000000000000000000000000000000000000000000000000000000000000000000000000000000000000001000000001000000001000000007000000001000000001000000000100000000000001000000000000000000010000000000001
1000000000001000000000V11111111111111111111111111111111110000000000000011111111111811111111111111111V1111111111111111111111111111111111111111111111111111111111111111111111111111111111111111111111V1111V11111111111111111111111111111111111111111111111111111111111111111111111111111111111111111111111111
100000000000100000000100000000100000000000100000000000001000000000000001000000000000000000001000000000000000010000000000000000000000000000000000000000000000000000000000000000000000000000000000000010000000000000V0000000000000001000000000000000000000000V000000000000010000000000000000000V0000000000001
1000000000001000000001000V000010000000000010000000000000100000000000000100000000000000000000100000000000000001000000000000000000000000000000000000000000000000000000000000000000000000000000000000001000000000000010000000000000001000000000000000000000000100000000000001000000000000000000010000000000001
1000000000001000000001000000001000000000001000000000000010000000000000010000000000000000000010000000000000000100000000000000000000000000000000000000A0000000000000000C0000000000000000000000000000001000000000000010000000000000001000000000000000000000000100000000000001000000000000000000010000000000001
1000000000001000000001000V000011000000000010000000000000100000000000000100000000000000000000100000000000000001000000000000000000000000000000000000000000000000000000000000000000000000000000000000001000000000000010000000000000001000000000000000000000000100000000000001000000000000000000010000000000001
100000000000100000000110000000070000000000V0000000000000V00000000000000100000000000000000000100000000000000001000000000000000000000000000000000000000000000000000000000000000000C0000000000000000000V00000000000001000000080000000100000000000V000000000000100000V0000000100000000000V00000001000000V000001
1000000000001000000000100000V001000000000010000000000000100000000000000100000000000000000000100000000000000001000000000000000000000000H00000000000000000000000000000000000000000000000000000000000001000000000000010000000000000001000000000000000000000000100000000000001000000000000000000010000000000001
1000000000001000000000100000000100000000001000V0000000001000000000000001000000000000000000001000000000000000010000000000000000000000000000000000000000000000000000000C0000000000000000000000000000001000000000000010000000000000001000000000000000000000000100000000000001000000000000000000010000000000001
1000000000001000000000100V00000100000000001000000000000010000000000000010000000000000000000010000000000000000100000000000000000000000000000000000000000000000000000000000000000000000000000000000000100000000000001000000000000000V00000000000000000000000010000000000000V000000000000000000010000000000001
1000000000001000000000111111111111111111111000000000000011V1111111111V11111111111181111111111111111111111VVV11V111111111111111111111111111111111111111111111111111111111111111111111111111111111111111111111111111111111111111111111111111111111111111111111111111111111111111111111111111111111111V1111111
10000000000010000000001000000001000000000010000000000000100000000000000100000000000000000000100000000000000001000V0000000000000000000000000000000000000000000000000000000000000000000000000000000000100000000000001000000000000000V000000000000000000000000100000000000001000000000000000000010000000000001
100000000000100000000010000C00010000A0000010000000000000100000000000000100000000000000000000100000000000000001000000000000000000000000000000000000000000000000000000000000000000000000000000000000001000000000000010000000000000001000000000000000000000000100000000000001000000000000000000010000000000001
100000000000100000000010000C0001000000000010000000000000100000000000000100000000000000000000100000000000000001000V00000000000000000000000000000000000000000000000000000000000000000000000000000000001000000000000010000000000000001000000000000000000000000100000000000001000000000000000000010000000000001
100000000000100000000010000C00010000000000100000000000001000000000000001000000000000000000001000000000000000010000000000000000000000000000000000000000000000000000000000000000000000000000000000000010000000000000100000000000000010000000000000000000000001000000000000080000000000000000000V0000000000001
100000000000100000000030000C0001000000000010000000000000100000000000000100000000000000000000100000000000000001000V000000000000000000000000000000000000000000000000000000000000000000000000000000000010000000V000001000000V000000001000000000000V00000000000100000V00000001000000000V0000000001000000V000001
100000000000100000000010000C000100000000001000000000V000100000000000000100000000000000000000100000000000000001000000000000000000000000000000000000000000000000000000000000000000000000000000000000001000000000000010000000000000001000000000000000000000000100000000000001000000000000000000010000000000001
100000000000100000000010000C000V0000A00000100000000000001000000000000001000000000000000000001000000000000000010000000000000000000000000000000000000000000000000000000000000000000000000000000000000010000000000000V0000000000000001000000000000000000000000100000000000001000000000000000000010000000000001
10000000000010000000001000000001000000000010000000000000100000000000000100000000000000000000100000000000000001000V00000000000000000000000000000000000000000000000000000000000000000000000000000000001000000000000010000000000000001000000000000000000000000V00000000000001000000000000000000010000000000001
1000000000001000000000111111111111111111111000000000000011111111V11111111181111111V11111181111VVV11111111111111111111111111111111111111111111111111111111111111111111111111111111111111111111111111V1111111V11111111111111111111111111111111111111111111111111111111111111111111111111111111111111111111111
1000000000001000000000V0000000010000000000100000000000001A000000V00000H1CV0000000000000000VC10000000000000000100000000000000000000000000000000000000000000000000000000000000000000000000000000000000100000000000001000000000000000100000000000000000000000010000000000000100000000000000000001A0000A00000A1
100000000000100000000010000000010C00HA00C0100000000000001000000V0V000001VV0000000000000000VV10000000000000000100000000000000000000000000000000000000000000000000000000000000000000000000000V0000000010000000000000100000000000000010000000000000000000000001000000000000010000000000000000000100H000000H001
1000000000001000000000100000000100000000001000V00000000010000000000000010000000000000000000010000000000000000100000H000000000000000000H00000A000000C0000C0000000000000000000C000000000000000000000001000000000000010000000000000001000000000000000000000000100000000000008000000000000000000010000000000001
100000000000100000000010000000010000000000V000000000000010000000000000010000000000000000000010000000000000000100000000000000000000000000000000000000000000000000000000000000000000000000000000000000100000000000001000000000000000V00000000000V0000000000001000000000000010000000000000000000V00C0C0C0C0C01
1000000000000000000000100000001000000000001000000000000010000000C000000100000000000000000000100000000000000001000000000000A000000000000000000000000000000000C00000000000000000000000000000000000000010000000000000100000000000000010000000000000000000000001000000V0000001000000000000000000010000000000001
1000000000000000000000100000001000000000001000000000000010000000C000000100000000000000000000100000000000000001000000000000000000000000000000000000000000000000000000000000000000000000000000000000001000000V00000010000000000000001000000000000000000000000V00000000000001000000V0000000000001000C00C00C001
1000000000000000000000100000001000000000001000000000000010000000C0000001VV0000000000000000VV10000000000000000100000000000000000000000000000V0000000000000000000000000000000000000000C0000000000000001000000000000010000000000000001000000000000000000000000100000000000001000000000000000000010000000C00001
100000000000000000000010000000V00000000000100000000000001000000000000001CV0000000000000000VC100000000000000001000000000000000000000000000000000000000000000000000000000000000000000000000000000000001000000000000010000000000000001000000000000000000000000100000000000001000000000000000000010000000000001
1111111111000111111111111111111111111111111000000000000011V111111111V11111V11111118111111V1111111111111111VVV1V111111111111111111111111111111111111111111111111111111111111111111111111111111111111111V11111111111111V1111111118111111111111111111111111111111111111111111111111111V1111111111111111V111111
100000000000000000000010000000000000000000100000000000000000000000000001000000000VVV0000000010000000000000000100000000000000000000000000000000000000000000000000000000000000000000000000000000000000100000000000001000000000000000100000000000000000000000010000000000000V000000000000000000010000000000001
100000000000000000000010000000000V000000001000000000000010000000000000010000000000000000000010000000000000000100000000000000C0000000000000V00000000000000000000000000000000V0000000000000000000000001000000000000010000000000000001000000000000000000000000100000000000001000000000000000000010000000000001
100000000000000000000010000V0000000000000010000000000000100A00000000A001000000000000000000001000000000000000010000000C0000000000000000000000000000000000000000000000000000000000000000000000000000001000000V000000100000000000000010000000000000000000000001000000V0000001000000000000000000010000000000001
1000000000000000000000V0000000000000000000V000000000000010000000000000010000000000000000000010000000000000000100000000000000000C00000000000000000000000000000000000000000000000000000000000000000000100000000000001000000000000000100000000000V000000000000100000000000001000000000000000000010000000000001
100000000000000000000010000000000V0000000010000000000000100000000000000100000000000000000000100000000000000001000C00000000000000000000000000000000000000000000000V0000000000000000000000000000000000100000000000001000000000000000100000000000000000000000010000000000000100000000000000000001000000000V001
100000000000000000000010000000000000000000100000V00000001000000000000001000000000000000000001000000000000000010000000000000000000000000000000000000000000000000000000000000000000000V0000000000000001000000000000010000000000000001000000000000000000000000800000000000001000000000000000000080000000000001
100000000000000000000011111111111111111111100000000000001000000H00000001111111111181111111111VVV111111111111111111111111111111111111111111111111111111111111111111111111111111111111111111111111111V1111111111111V11111111V11111111111111111118111111111111111111111111111111111111111111111111111111111111
1000000000000000000000000V0000000000000000100000000000001000000000000001000000000V0V0000000010000000000000000100000000000000000000000000000000000000000000000000000000000000000000000000000000000000100000000000001000000000000000100000000000000000000000010000000000000100000000000000000002V0V000V000001
1000000000000000000000000000000000000000V01000000000C00010000000000000010000000000000000000010000000000000000100000000000000000000V00000000000000000000000000000000000000000000000000000000000000000100000000000001000C000C0000C001000000000000000000000000100000000000001000000000V0000000002V0V000000V001
1000000000000000000000000000000000V000000010000000000000100000000000000100000000000000000000100000000000000001000000000000000000000000000000000000000000000000000000000V0000000000000000000000000000100000000000001000000000000000100000000000000000000000010000000000000100000000000000000002V0V000V000001
10000000000000000000000000000V00000000V000V0000000000000100000000000000100000000000000000000100000000000000001000000000V00000000000000000000000V0000000000000000000000000000000000000000000000000000100000000000001000A000A0000A00100000V0000000000000000001000000A000000V0000000000000000000800V0000000001
1000000000000000000000000000000000V0000000100000000000001000000000000001000000000000000000001000000000000000010000000000000000000000000000000000000000000000000000000000000000000V0000000000000000001000000V0000001000000000000000100000000000000000000000010000000000000100000000000000000002V0V000V000001
1000000000000000000000000000000000000000V01000V00000000010H0000000000H0100000000000000000000100000000000000001000000000000000000000V0000000000000000000000000000000000000000000000000000000000000000100000000000001000H000H0000H001000000000000000000000000100000000000001000000000V0000000002V0V000000V001
1000000000000000000000000V00000000000000001000000000000010000000000000010000000000000000000010000000000000000100000000000000000000000000000000000000000000000000000000000000000000000000000000000000100000000000001000000000000000100000000000000000000000010000000000000100000000000000000002V0V000V000001
1000000000000000000000111111111111111111111000000000V00011111111V11111111111111111811111111111111111111111VVV1V111111111111111111111111111111111111111111111111111111111111111111111111111111111111111V111111111111V1111111111111V1V111111111111111111111111V11111111111V111111111111111111111111111111VVV1
1000000000000000000000100000000000000000001000000000000010000000000000010000000000000000000010000000000000VVV10A0000000000000000000000000000000000000000000000000000000000000000000000000000000000001000000000000010000000000000001000000000000000000000000100000000000001000000000000000000000000000000001
10000000000000000000001000000000000000000010000000000000100000000000000100000000000000000000100000000000000001AH0000000000000000000000000000000000000000000000000000000000000000000000000000000000001000000000000010000000000000001000000000000000000000000100000000000001000000000000000000000000000000001
100000000000000000000010000000000000000000100C0000000000100000000000000100000000000000000000100000000000000001000000000000000000V00000000000V00000000000000000000000000000000000000000000000000000001000000000000010000000000000001000000000000000000000000100000000000001000000000000000000000000000000001
1000000000000000000000100000000000000000001000000000000010000000000000010000000000000000000010000000000000000100000000000000000000000000000000000000000000000000000000000000000000000000000000000000100000000000001000000000000000100000V0000000V0000000000100000000000001000000000000000000000000000000001
1000000000000000000000100000000000000000001000000000000010000000000000010000000000000000000010000000000000V0010000000000000000000000000000000000000V00000000000V000000000000V000000000000000000000001000000000000010000000000000001000000000000000000000000100000000000001000000000000000000000000000000001
1000000000000000000000100000000000000000001000000000V000100000000000000100000000000000000000100000000000000001000000000000000000000000000000000000000000000000000000000000000000000000000000000000001000000000000010000000000000001000000000000000000000000100000000000001000000000000000000000000000000001
1000000000000000000000100000000000000000001000000000000010000000000000010000000000000000000010000000000000000100000000000000000000000000000000000000000000000000000000000000000000000000000000000000100V000000000010000000000000001000000000000000000000000100000000000001000000000000000000000000000000001
1000000000000000000000100000000000000000001000V00000000010000000000000010000000000000000000010000000V00000C001000000000000000000000000000000000000000000000000000000000000000000000000000000000000001000000000000010000000000000001000000V00000000000000000100000000000001000000000000000000000000000000001
10000000000000000000001000000000000000000010000000000000100000000000000100000000000000000000100000000000000001000000000000000000000000000000000000000000000000000000000000000000000000000000000000001000000000000010000000000000001000000000000000V00000000100000000000001000000000000000000000000000000001
10000000000000000000001000000000000000000010000000C0000010000000000000010000000000000000000010000000000000000100000000000000000000000000000000000000000000000000000000000000000000000000000000000000100000000V000010000000000000001000000000000000000000000100000000000001000000000000000000000000000000001
1000000000000000000000100000000000000000001000V00000000010000000000000010000000000000000000010000000000000000100000000000000000000000000000000000000000000000000000000V000000000000000000000000000001000000000000010000000V00000001000000000000000000000000100000000000001000000000000000000000000000000001
10000000000000000000001000000000000000000010000000000000100000000000000100000000000000000000100000000000000001000000000000000000000000000000000V000000000000000000000000000000000000000000000000000010000000000000100000000000000010000000000000000000000001000000000000011111111111111111G1111111111111111
10000000000000000000001000000000000000000010000000000V00100000000000000100000000000000000000100C00000000000001000000000000000000000000000000000000000000000000000000000000000000000000000000000000001000000000000010000000000000001000V000000V0000000000000100000000000001000000000000000000000000000000001
100000000000000000000010000000000000000000100000C0000000100000000000000100000000000000000000100000000V00000001000000000000000000000000000000000000000000000000000000000000000000000000000000000000001000000000000010000000000000001000000000000000000000000100000000000001000000000000000000000000000000001
10000000000000000000001000000000000000000010000000000000100000000000000100000000000000000000100000000000000001000000000000000000V000000000000000000000000000000000000000000V00000000000000000000000010000V00000000100000000000000010000000000000000V0000000100000000000001000000000000000000000000000000001
100000000000000000000010000000000000000000100V000000C000100000000000000100000000000000000000100000000000000001000000000000000000000000000000000000000000000000000000000000000000000000000000000000001000000000000010000000000000001000000000000000000000000100000000000001000000000000000000000000000000001
10000000000000000000001000000000000000000010000000000000100000000000000100000000000000000000100000000000000001000000000000000000000000000000000000000000000000000000000000000000000000000000000000001000000000000010000000000000001000000000000000000000000100000000000001000000000000000000000000000000001
1000000000000000000000100000000000000000001000000V00000000000000000000010000000000000000000010000000000000000100000000000000000000000000000000V000000000000000000000000000000000000000000000000000001000000000000010000000000000001000000000000000000000000100000000000001000000000000000000000000000000001
100000000000000000000010000000000000000000100000000000V00000000000000001000000000000000000001000V0000C00000001000000000000000000000000000000000000000000000000000000000000000000000000000000000000001000000000V00010000000000000001000000000000000000000000100000000000001000000000000000000000000000000001
10000000000000000000001000000000000000000010000000000000000000000000000100000000000000000000100000000000000001000000000000000000000000000000000000000000000000V00000000000000000000000000000000000001000000000000010000000000000001000000V00000000000V00000100000000000001000000000000000000000000000000001
100000000000000000000010000000000000000000100V000000V0000000000000000001000000000000000000001000000000000V000100000000000000000000000000000000000000000000000000000000000000000000000000000000000000100V000000000010000000000000001000000000000000000000000100000000000001000000000000000000000000000000001
10000000000000000000001000000000000000000010000000000000000000000000000100000000000000000000100000000000000001000000000000000000000000000000000000000000000000000000000000000000000000000000000000001000000000000010000000000000001000000000000000000000000100000000000001000000000000000000000000000000001
11111111110001111111111111111111111111111111111113111111100000000000000111111111VVV1111111111111111118111111111111111111111111111111111111111111111111111111111111111111111111111111111111111111111V1111111111111V111111118111111111111111111111111111111181111111111111C1000000111111111111111111111111111
10000000000H00000000001000000000000000000010000000000000100000000000000100000000000000000000100000000V0000000V000000000000000000000000000000000000000000000000000000000000000000000C000000000000000010000000000H001000000000000000100000000000000000000000V100000000000001000000000000000000000000000000001
1000000000000000000000100000A0000000H00000100C000C000C0010000000000000010000000000000000000010000000000000000800000000000000000000000V000000000000000000000000000000000000000000000C0000000000000000100H000000000010000000000000001000000000000000000000000100000000000001000000000000000000000000000000001
10H00000000D00000000H010000000000000000000100C000C000C0010000000000000010000000000000000000010000000000000000100000000000000000000000000000000000000000000000000000000000000000000000000000000000000100000A000H00010000000000000001000000000000000000000000100000000000001000000000000000000000000000000001
100000000A000A000000001000000000M000000000100C000C000C00100000000000000V0000000000000000000010000000000000000100000000000000000000000000000000000000000000000000000000V000000000000000000000000000001000000000000010000000V000000030000000000000000000000001000000H0000001000000000000000000000000000000001
131111111111111111111110000000000000000000100C000C000C00100000000000000100000000000000000000100000000000000001000000000V0000000000000000000000000000000000000000000000000000000000000000000000000000100A00H000H00010000000000000001000000000000000000000000100000000000001000000000000000000000000000000001
1000000A00000H00000000700000H0000000A000001000A0H0A0H000100000000000000100000000000000000000100000000000000001000000000000000000000000000000000000000V00000000000000000000000000000C00000000000000001000000000000010000000000000001000000000000000000000000100000000000001000000000000000000000000000000001
1000H00000A00000A000007000000000000000000070000000000000100000000000000100000000000000000000100000000000000001000000000000000000000000000000000000000000000000000000000000000000000C000000000000000010C00C00C0C000V0000000000000001000000000000000000000000800000000000001000000000000000000000000000000001
11111111111111111111111111111111111111111111111111111111111111111111111111111111111111111111111111111111111111111111111111111111111111111111111111111111111111111111111111111111111111111111111111111111111111111111111111111111111111111111111111111111111111111111111111111111111111111111111111111111111